,county,irrig07,irrig12,irrHarv07,irrHarv12,cropland07,cropland12,pasture07,pasture12,irrig12_a,,irrigRatio12,Irrigated Crop Intensity
1214,Massachusetts\Dukes,120,205,84,129,1104,0,36,76,129,129,inf,1
1817,New Mexico\Otero,7045,5966,4033,4360,18562,0,3012,1606,4360,4360,inf,1
1855,New York\Kings,0,8,0,8,0,0,0,0,8,8,inf,1
1874,New York\Richmond,14,8,14,8,0,0,0,0,8,8,inf,1
1922,North Carolina\Dare,6,6,6,6,4747,0,0,0,6,6,inf,1
1981,North Carolina\Swain,29,19,29,19,1495,0,0,0,19,19,inf,1
2932,Virginia\York,18,22,18,22,292,0,0,0,22,22,inf,1
180,California\Inyo,32530,23832,4025,0,8261,18670,28505,0,23832,23832,1.276486342,0
80,Arizona\Greenlee,5291,5398,3381,0,6687,5226,1910,0,5398,5398,1.032912361,0
563,Idaho\Jerome,150842,148950,141106,141589,157624,148878,9736,7361,141589,141589,0.951040449,1
186,California\Madera,281658,292274,260596,282728,290683,304248,21062,9546,282728,282728,0.929268229,1
550,Idaho\Canyon,197322,225310,168981,202263,191719,217846,28341,23047,202263,202263,0.928467817,1
179,California\Imperial,376535,455033,375167,450186,396663,487892,1368,4847,450186,450186,0.922716503,1
192,California\Mono,22217,21506,8144,10480,10479,11378,14073,11026,10480,10480,0.92107576,1
570,Idaho\Minidoka,191585,204534,186664,199102,202668,217383,4921,5432,199102,199102,0.915904188,1
574,Idaho\Payette,54648,56930,39849,47033,56068,51649,14799,9897,47033,47033,0.910627505,1
1751,Nevada\Esmeralda,13739,17455,0,0,12769,19223,0,0,17455,17455,0.908026843,0
89,Arizona\Yuma,174245,181403,172143,181197,193053,200128,2102,206,181197,181197,0.90540554,1
1752,Nevada\Eureka,46241,46658,34940,44488,50875,49146,11301,2170,44488,44488,0.905221178,1
537,Idaho\Ada,56973,55254,45866,47985,66122,53441,11107,7269,47985,47985,0.897906102,1
1830,New Mexico\Valencia,20951,23106,15302,20894,25207,23428,5649,2212,20894,20894,0.891838825,1
205,California\San Joaquin,453980,485402,426670,460727,492032,517918,27310,24675,460727,460727,0.889575184,1
562,Idaho\Jefferson,210328,175347,196067,169376,225134,191074,14261,5971,169376,169376,0.886441902,1
172,California\Colusa,277332,260859,268737,252047,298996,285689,8595,8812,252047,252047,0.882242578,1
560,Idaho\Gooding,132641,141983,118200,132493,133793,150659,14441,9490,132493,132493,0.879423068,1
216,California\Stanislaus,374997,320784,297053,299331,351195,340890,77944,21453,299331,299331,0.878086773,1
324,Florida\Glades,46726,88509,39077,49320,50803,56473,7649,39189,49320,49320,0.873337701,1
1721,Nebraska\Phelps,246754,231896,245322,231332,281690,264991,1432,564,231332,231332,0.872980592,1
91,Arkansas\Arkansas,310745,314596,0,314440,359044,360246,0,156,314440,314440,0.872847998,1
1755,Nevada\Lincoln,18320,22007,15454,19528,17903,22380,2866,2479,19528,19528,0.87256479,1
217,California\Sutter,231713,244305,223199,240003,274439,275849,8514,4302,240003,240003,0.870052094,1
194,California\Napa,51604,54580,46403,0,66184,63049,5201,0,54580,54580,0.865675903,0
1759,Nevada\Pershing,48447,52785,43227,49640,69187,57379,5220,3145,49640,49640,0.865124871,1
578,Idaho\Twin Falls,244520,256974,218451,237686,267067,275101,26069,19288,237686,237686,0.863995405,1
106,Arkansas\Craighead,244365,271621,0,271493,301734,314247,0,128,271493,271493,0.863947786,1
1762,Nevada\White Pine,30877,32653,15985,20991,23756,24337,14892,11662,20991,20991,0.862513868,1
190,California\Merced,514162,468226,458017,449569,537716,522593,56145,18657,449569,449569,0.86026602,1
1693,Nebraska\Hamilton,257748,235492,257101,234582,291752,273153,647,910,234582,234582,0.858793423,1
130,Arkansas\Lincoln,99861,135047,0,135047,131580,157453,0,0,135047,135047,0.857697218,1
542,Idaho\Bingham,316933,333434,290788,316848,362149,369534,26145,16586,316848,316848,0.857425839,1
222,California\Ventura,91253,87148,90018,86667,113862,101084,1235,481,86667,86667,0.857376044,1
82,Arizona\Maricopa,199367,192871,189141,190583,267295,222469,10226,2288,190583,190583,0.856672166,1
2820,Utah\Wayne,18905,15720,14812,13054,19218,15295,4093,2666,13054,13054,0.85348153,1
2793,Utah\Beaver,29917,37615,24169,31667,35394,37111,5748,5948,31667,31667,0.85330495,1
170,California\Butte,202234,199662,192928,193721,222713,227279,9306,5941,193721,193721,0.852348875,1
3127,Wyoming\Washakie,44402,38426,39907,34030,46629,39942,4495,4396,34030,34030,0.851985379,1
92,Arkansas\Ashley,90804,70755,90804,0,120139,83652,0,0,70755,70755,0.845825563,0
1692,Nebraska\Hall,206897,207639,205582,207157,247081,245395,1315,482,207157,207157,0.844177754,1
109,Arkansas\Cross,191622,214710,0,0,254423,255241,0,0,214710,214710,0.841204979,0
146,Arkansas\Poinsett,262180,310028,262180,310028,322991,369758,0,0,310028,310028,0.838461913,1
535,Hawaii\Maui,28027,41548,24024,0,54557,49578,4003,0,41548,41548,0.838032999,0
79,Arizona\Graham,28300,36922,27066,34889,35251,41699,1234,2033,34889,34889,0.836686731,1
149,Arkansas\Prairie,176263,179147,176263,178575,234670,214078,0,572,178575,178575,0.834158578,1
1713,Nebraska\Merrick,163806,167430,163185,166811,199641,200159,621,619,166811,166811,0.833392453,1
1756,Nevada\Lyon,81500,87673,55307,65218,78910,78269,26193,22455,65218,65218,0.833254545,1
176,California\Fresno,984455,968727,960215,960075,1102163,1153351,24240,8652,960075,960075,0.83242222,1
177,California\Glenn,236134,242932,222803,227439,250279,274310,13331,15493,227439,227439,0.829131275,1
111,Arkansas\Desha,229730,202069,0,202069,280455,243918,0,0,202069,202069,0.828430046,1
573,Idaho\Owyhee,115171,133530,101680,115972,136575,140719,13491,17558,115972,115972,0.824138887,1
568,Idaho\Lincoln,67994,71429,53762,59537,68388,72605,14232,11892,59537,59537,0.820012396,1
2801,Utah\Garfield,22331,19619,10311,14394,17436,17555,12020,5225,14394,14394,0.81993734,1
1754,Nevada\Lander,31443,37203,27420,36423,37951,44616,4023,780,36423,36423,0.816366326,1
548,Idaho\Butte,54475,58675,46362,55880,61868,68609,8113,2795,55880,55880,0.814470405,1
221,California\Tuolumne,2135,2265,503,0,5622,2785,1632,0,2265,2265,0.813285458,0
353,Florida\Palm Beach,387755,362748,385400,356870,450665,440747,2355,5878,356870,356870,0.809693543,1
220,California\Tulare,550342,557361,540887,548400,638789,677506,9455,8961,548400,548400,0.809439326,1
1747,Nevada\Churchill,40346,53617,32392,45486,36379,56300,7954,8131,45486,45486,0.807921847,1
182,California\Kings,421571,407417,419080,404943,512870,501500,2491,2474,404943,404943,0.807463609,1
333,Florida\Indian River,66866,57627,51928,44235,81264,54783,14938,13392,44235,44235,0.807458518,1
125,Arkansas\Jefferson,200247,207481,200205,0,259227,257539,42,0,207481,207481,0.805629439,0
1745,Nebraska\York,254711,252439,253799,251859,314696,313071,912,580,251859,251859,0.804478856,1
3120,Wyoming\Park,111873,110277,87501,88353,113460,109878,24372,21924,88353,88353,0.804100912,1
138,Arkansas\Monroe,163211,199486,0,199328,210980,248852,0,158,199328,199328,0.800990147,1
181,California\Kern,786255,729956,756645,719971,942827,899395,29610,9985,719971,719971,0.800505896,1
164,Arkansas\Woodruff,169456,196986,0,196683,246599,245952,0,303,196683,196683,0.799680425,1
2239,Oregon\Malheur,198683,183003,159169,163525,240143,204769,39514,19478,163525,163525,0.798582793,1
1805,New Mexico\Dona Ana,79019,76347,77572,74799,95788,93809,1447,1548,74799,74799,0.797354198,1
2230,Oregon\Hood River,16409,14133,15044,12984,18354,16284,1365,1149,12984,12984,0.797347089,1
1731,Nebraska\Scotts Bluff,155576,199195,146390,190435,192776,239731,9186,8760,190435,190435,0.794369523,1
1702,Nebraska\Kearney,216336,194547,214837,192801,272177,242767,1499,1746,192801,192801,0.794181252,1
345,Florida\Martin,48521,34806,41753,0,51933,43837,6768,0,34806,34806,0.793986815,0
101,Arkansas\Clay,227000,235621,227000,0,293353,297992,0,0,235621,235621,0.790695723,0
3107,Wyoming\Big Horn,110958,108707,75605,78283,116477,99230,35353,30424,78283,78283,0.788904565,1
2798,Utah\Davis,12244,13809,8685,10216,12383,12960,3559,3593,10216,10216,0.788271605,1
85,Arizona\Pima,35684,32404,32358,28654,49641,36717,3326,3750,28654,28654,0.780401449,1
81,Arizona\La Paz,100498,93178,99991,0,123314,120001,507,0,93178,93178,0.776476863,0
1800,New Mexico\Chaves,63053,49755,52734,48752,85353,62979,10319,1003,48752,48752,0.774099303,1
559,Idaho\Gem,35135,34165,23245,24556,34919,31739,11890,9609,24556,24556,0.773685371,1
1749,Nevada\Douglas,31242,25622,15271,14378,20931,18605,15971,11244,14378,14378,0.77280301,1
99,Arkansas\Chicot,141805,197142,141186,196729,221290,254915,619,413,196729,196729,0.771743522,1
112,Arkansas\Drew,59337,66873,59185,0,80654,86776,152,0,66873,66873,0.770639347,0
2803,Utah\Iron,59138,61619,50275,59750,87550,77560,8863,1869,59750,59750,0.770371325,1
1753,Nevada\Humboldt,116270,137470,102124,127218,153261,165292,14146,10252,127218,127218,0.769656124,1
1806,New Mexico\Eddy,52974,43254,48607,40759,67498,52973,4367,2495,40759,40759,0.769429709,1
1676,Nebraska\Dawson,263867,248463,261852,247351,330690,321769,2015,1112,247351,247351,0.768722282,1
166,California,8016159,7861964,7274248,7371411,9464647,9591783,741911,490553,7371411,7371411,0.768513112,1
152,Arkansas\St. Francis,144804,209256,144753,209256,225938,273310,51,0,209256,209256,0.765636091,1
269,Colorado\Montrose,85656,70407,55860,53561,93262,69957,29796,16846,53561,53561,0.765627457,1
1211,Massachusetts\Barnstable,1263,1180,1250,0,2029,1543,13,0,1180,1180,0.764744005,0
118,Arkansas\Greene,164615,165966,164615,165466,229272,216574,0,500,165466,165466,0.764015995,1
279,Colorado\Rio Grande,102792,93615,83389,80467,114370,105379,19403,13148,80467,80467,0.763596162,1
275,Colorado\Pitkin,9971,7538,3556,3665,4785,4809,6415,3873,3665,3665,0.762112705,1
2225,Oregon\Deschutes,37821,33979,21191,22012,39857,28916,16630,11967,22012,22012,0.761239452,1
124,Arkansas\Jackson,178101,206529,0,0,266354,271738,0,0,206529,206529,0.760029882,0
543,Idaho\Blaine,43965,41930,31751,36160,54197,47596,12214,5770,36160,36160,0.759727708,1
1634,Montana\Powell,74103,53316,52996,40553,71019,53524,21107,12763,40553,40553,0.757660115,1
566,Idaho\Lemhi,76956,56665,34468,37671,53574,49735,42488,18994,37671,37671,0.757434402,1
1653,Nebraska\Adams,203549,215269,203117,214122,265408,284338,432,1147,214122,214122,0.753054463,1
316,Florida\DeSoto,56162,47695,53842,46493,91316,62382,2320,1202,46493,46493,0.745295117,1
534,Hawaii\Kauai,14074,22523,0,0,22336,30236,0,0,22523,22523,0.744906734,0
311,Florida\Charlotte,19965,13716,18471,0,28721,18447,1494,0,13716,13716,0.743535534,0
224,California\Yuba,70987,82475,60957,66695,71009,89761,10030,15780,66695,66695,0.74302871,1
74,Arizona,876158,880613,823468,854515,1205425,1150811,52690,26098,854515,854515,0.742532875,1
1746,Nevada,691030,687790,502978,561201,753718,756852,188052,126589,561201,561201,0.741493713,1
359,Florida\St. Lucie,69302,59245,53157,49302,62637,66559,16145,9943,49302,49302,0.740726273,1
2797,Utah\Daggett,9179,7294,5481,5102,8579,6917,3698,2192,5102,5102,0.737603007,1
1636,Montana\Ravalli,72235,61574,36228,37837,63047,51301,36007,23737,37837,37837,0.737548976,1
2813,Utah\Sevier,52473,40171,31474,32841,42605,44604,20999,7330,32841,32841,0.736279257,1
2821,Utah\Weber,29624,37742,22765,24179,31251,32879,6859,13563,24179,24179,0.735393412,1
193,California\Monterey,232969,263835,224333,263118,311052,358294,8636,717,263118,263118,0.7343634,1
86,Arizona\Pinal,215121,223626,208284,221997,256042,302591,6837,1629,221997,221997,0.733653678,1
200,California\Sacramento,113427,85979,102160,77557,133628,105721,11267,8422,77557,77557,0.733600704,1
1826,New Mexico\Socorro,14815,18906,11049,15686,23815,21402,3766,3220,15686,15686,0.732922157,1
2812,Utah\Sanpete,70770,68864,50921,54828,98230,74853,19849,14036,54828,54828,0.732475652,1
1642,Montana\Silver Bow,8797,4590,6488,3213,15750,4388,2309,1377,3213,3213,0.732224248,1
1670,Nebraska\Clay,218108,191700,216574,189070,291501,259146,1534,2630,189070,189070,0.729588726,1
128,Arkansas\Lawrence,130983,130317,130983,130250,200765,179193,0,67,130250,130250,0.726869911,1
2955,Washington\Kittitas,82147,66908,52422,49654,69739,68314,29725,17254,49654,49654,0.726849548,1
223,California\Yolo,246341,229901,237811,223046,311307,306915,8530,6855,223046,223046,0.726735415,1
133,Arkansas\Lonoke,211362,199627,211128,199305,293183,274568,234,322,199305,199305,0.725885755,1
2235,Oregon\Lake,154122,148883,99247,95067,169436,131055,54875,53816,95067,95067,0.725397734,1
2816,Utah\Uintah,84529,68950,42529,45186,83168,62450,42000,23764,45186,45186,0.723554844,1
1615,Montana\Granite,31280,28520,20354,19707,35460,27391,10926,8813,19707,19707,0.719469899,1
1654,Nebraska\Antelope,261266,249735,259587,246721,369071,343927,1679,3014,246721,246721,0.717364441,1
265,Colorado\Mesa,64272,75305,41619,51160,131178,71399,22653,24145,51160,51160,0.716536646,1
83,Arizona\Mohave,17107,20814,15956,0,31232,29054,1151,0,20814,20814,0.71639017,0
1682,Nebraska\Fillmore,223522,210981,223124,210744,322967,296448,398,237,210744,210744,0.710897021,1
1724,Nebraska\Polk,164566,151016,163730,150788,228592,212173,836,228,150788,150788,0.710684206,1
2806,Utah\Millard,103272,115207,94587,107560,153728,151587,8685,7647,107560,107560,0.709559527,1
255,Colorado\Jackson,89603,59555,52096,46503,80270,65538,37507,13052,46503,46503,0.709557814,1
2808,Utah\Piute,16913,13885,10701,10568,19481,14953,6212,3317,10568,10568,0.70674781,1
1473,Mississippi\Washington,166432,220926,166432,220926,310190,312998,0,0,220926,220926,0.705838376,1
208,California\Santa Barbara,95091,96695,88559,93334,124965,132323,6532,3361,93334,93334,0.705349788,1
569,Idaho\Madison,128229,122275,123869,118041,176069,167384,4360,4234,118041,118041,0.705210773,1
3123,Wyoming\Sublette,141373,143134,82147,86235,117872,122565,59226,56899,86235,86235,0.703585852,1
2809,Utah\Rich,51752,65965,38138,54137,76535,77152,13614,11828,54137,54137,0.701692762,1
2799,Utah\Duchesne,101974,100909,46975,54749,93398,78172,54999,46160,54749,54749,0.70036586,1
3112,Wyoming\Fremont,164331,157073,117042,117602,170074,167985,47289,39471,117602,117602,0.700074411,1
1439,Mississippi\Leflore,144820,164126,144550,0,262986,235795,270,0,164126,164126,0.696053776,0
1662,Nebraska\Buffalo,269141,240799,266333,238249,371615,342337,2808,2550,238249,238249,0.695948729,1
272,Colorado\Ouray,10681,9823,7525,7000,10152,10068,3156,2823,7000,7000,0.695272149,1
1222,Massachusetts\Plymouth,11861,11994,11810,11949,18302,17268,51,45,11949,11949,0.691973593,1
202,California\San Bernardino,28977,21788,26614,20615,35898,29827,2363,1173,20615,20615,0.691152312,1
552,Idaho\Cassia,249848,237831,233008,230650,372773,333822,16840,7181,230650,230650,0.690937086,1
2940,Washington\Chelan,28230,22778,24925,21790,43503,31537,3305,988,21790,21790,0.690934458,1
210,California\Santa Cruz,19641,28897,18964,28389,23588,41094,677,508,28389,28389,0.690830778,1
346,Florida\Miami-Dade,38954,45236,38839,44615,53816,64904,115,621,44615,44615,0.687399852,1
1822,New Mexico\San Juan,78438,85890,70773,79350,107385,115578,7665,6540,79350,79350,0.686549343,1
327,Florida\Hardee,44141,36038,43329,35510,66298,51767,812,528,35510,35510,0.685958236,1
555,Idaho\Custer,55963,51571,31506,30464,46949,44421,24457,21107,30464,30464,0.68580176,1
2975,Washington\Yakima,267566,224386,238850,210313,344505,306851,28716,14073,210313,210313,0.685391281,1
1138,Louisiana\Morehouse,140448,141500,139088,0,221586,206749,1360,0,141500,141500,0.684404761,0
1403,Mississippi\Bolivar,228300,247777,228300,247520,389487,361995,0,257,247520,247520,0.68376635,1
556,Idaho\Elmore,97857,89940,81253,80075,120841,117855,16604,9865,80075,80075,0.679436596,1
330,Florida\Highlands,73713,61785,70386,56966,120464,84007,3327,4819,56966,56966,0.678110157,1
144,Arkansas\Phillips,245359,231860,0,0,424166,345619,0,0,231860,231860,0.670854322,0
218,California\Tehama,76081,84912,51546,59900,94214,89348,24535,25012,59900,59900,0.67041232,1
1464,Mississippi\Sunflower,187703,216718,0,0,330940,323844,0,0,216718,216718,0.669204926,0
1804,New Mexico\De Baca,11460,8070,6236,7470,16140,11171,5224,600,7470,7470,0.66869573,1
241,Colorado\Delta,66169,59232,40128,40556,67298,60717,26041,18676,40556,40556,0.667951315,1
343,Florida\Manatee,50791,50108,47283,46914,77299,70380,3508,3194,46914,46914,0.666581415,1
281,Colorado\Saguache,103292,90516,82126,76429,118229,115316,21166,14087,76429,76429,0.662778799,1
185,California\Los Angeles,29710,39653,25309,39424,49158,59556,4401,229,39424,39424,0.661965209,1
1492,Missouri\Butler,134006,123634,0,123196,214774,186202,0,438,123196,123196,0.661625546,1
418,Georgia\Dougherty,15225,12971,0,0,33055,19733,0,0,12971,12971,0.657325293,0
237,Colorado\Conejos,119126,100080,84416,73851,123022,112624,34710,26229,73851,73851,0.655730573,1
544,Idaho\Boise,1982,2390,1131,1965,4137,3017,851,425,1965,1965,0.651309248,1
252,Colorado\Gunnison,40729,42213,25313,26982,33829,41632,15416,15231,26982,26982,0.648107225,1
351,Florida\Orange,11870,9478,11590,8907,20737,13790,280,571,8907,8907,0.645902828,1
320,Florida\Flagler,6812,3936,6568,3513,8682,5455,244,423,3513,3513,0.643996334,1
191,California\Modoc,132731,128360,95139,99580,145784,154728,37592,28780,99580,99580,0.643580994,1
1782,New Jersey\Essex,21,18,0,18,43,28,0,0,18,18,0.642857143,1
129,Arkansas\Lee,174518,157999,0,157944,288419,245889,0,55,157944,157944,0.642338616,1
3125,Wyoming\Teton,18222,14684,9414,6762,18474,10545,8808,7922,6762,6762,0.641251778,1
203,California\San Diego,62213,45164,58264,43614,102502,68219,3949,1550,43614,43614,0.639323356,1
2229,Oregon\Harney,150803,165664,117169,141920,244159,222987,33634,23744,141920,141920,0.636449659,1
1607,Montana\Deer Lodge,19692,10760,10813,7107,19094,11203,8879,3653,7107,7107,0.634383647,1
174,California\Del Norte,7660,9229,2848,5455,7986,8609,4812,3774,5455,5455,0.633639215,1
251,Colorado\Grand,43130,27547,22808,22015,38831,34862,20322,5532,22015,22015,0.631489874,1
1596,Montana\Beaverhead,203539,238454,106074,112745,180456,178618,97465,125709,112745,112745,0.631207381,1
232,Colorado\Boulder,33871,30126,27135,24741,54425,39228,6736,5385,24741,24741,0.630697461,1
151,Arkansas\Randolph,67301,56920,0,56637,135019,89856,0,283,56637,56637,0.630308494,1
234,Colorado\Chaffee,15139,13534,10862,10014,21872,15890,4277,3520,10014,10014,0.630207678,1
358,Florida\St. Johns,14359,11650,14213,11608,19550,18473,146,42,11608,11608,0.62837655,1
328,Florida\Hendry,188817,193073,166780,164552,262419,262438,22037,28521,164552,164552,0.627012856,1
1699,Nebraska\Howard,104273,115436,103101,114353,157759,182496,1172,1083,114353,114353,0.626605515,1
199,California\Riverside,168051,145961,158437,142249,219943,227246,9614,3712,142249,142249,0.625969214,1
227,Colorado\Alamosa,94030,68623,66837,44675,91098,71475,27193,23948,44675,44675,0.625043722,1
496,Georgia\Seminole,45798,38939,45331,38703,71031,62041,467,236,38703,38703,0.623829403,1
2217,Oregon\Baker,120742,100898,60463,66873,115067,107531,60279,34025,66873,66873,0.621895081,1
137,Arkansas\Mississippi,269564,286923,0,286923,451917,462633,0,0,286923,286923,0.620195706,1
2233,Oregon\Josephine,8798,9000,5383,5167,17389,8365,3415,3833,5167,5167,0.617692767,1
1619,Montana\Lake,86526,80691,49204,49720,98787,80650,37322,30971,49720,49720,0.616491011,1
3109,Wyoming\Carbon,146547,165476,69029,77619,123490,126434,77518,87857,77619,77619,0.613909233,1
1740,Nebraska\Valley,99325,93080,98817,92481,147845,150695,508,599,92481,92481,0.613696539,1
87,Arizona\Santa Cruz,1714,1812,436,757,7956,1238,1278,1055,757,757,0.611470113,1
1411,Mississippi\Coahoma,130899,138021,130899,0,265566,226794,0,0,138021,138021,0.608574301,0
1824,New Mexico\Santa Fe,50025,8864,8152,7950,21514,13091,41873,914,7950,7950,0.607287449,1
90,Arkansas,4460682,4803902,4455478,4795969,8432221,7931111,5204,7933,4795969,4795969,0.604703301,1
3117,Wyoming\Lincoln,65298,72701,52884,59561,93900,98541,12414,13140,59561,59561,0.604428613,1
285,Colorado\Summit,10509,4217,3895,3513,7119,5816,6614,704,3513,3513,0.604023384,1
2231,Oregon\Jackson,56420,36549,26783,19577,56530,32765,29637,16972,19577,19577,0.597497329,1
1776,New Jersey\Atlantic,11702,11281,11641,11263,18616,18905,61,18,11263,11263,0.595768315,1
1300,Michigan\St. Joseph,102859,112442,102591,112130,181051,188221,268,312,112130,112130,0.595735864,1
3124,Wyoming\Sweetwater,30284,28424,23269,21356,46144,36024,7015,7068,21356,21356,0.592827004,1
1552,Missouri\New Madrid,198843,196541,198695,196541,373357,332498,148,0,196541,196541,0.591104307,1
1122,Louisiana\East Carroll,102258,125644,102104,125644,225236,214275,154,0,125644,125644,0.586367985,1
356,Florida\Polk,98404,79869,95980,73238,136281,125095,2424,6631,73238,73238,0.585459051,1
1515,Missouri\Dunklin,159471,155819,159150,155687,317069,266226,321,132,155687,155687,0.58479262,1
2800,Utah\Emery,41823,51743,19040,24301,58570,41591,22783,27442,24301,24301,0.584285062,1
238,Colorado\Costilla,63525,34330,41455,29085,59045,49896,22070,5245,29085,29085,0.582912458,1
1795,New Jersey\Union,36,32,36,32,65,55,0,0,32,32,0.581818182,1
2232,Oregon\Jefferson,48351,41055,42241,36478,97191,62864,6110,4577,36478,36478,0.580268516,1
338,Florida\Lee,14612,13585,14269,13199,21960,22816,343,386,13199,13199,0.578497546,1
2949,Washington\Grant,469790,428200,451713,415595,771805,720023,18077,12605,415595,415595,0.57719684,1
214,California\Solano,145988,130909,97638,97890,154937,169637,48350,33019,97890,97890,0.577055713,1
259,Colorado\Lake,2715,3571,182,459,6116,796,2533,3112,459,459,0.576633166,1
1689,Nebraska\Gosper,81402,98765,80363,98589,130355,171793,1039,176,98589,98589,0.573882521,1
472,Georgia\Mitchell,47675,67179,46383,0,126613,117354,1292,0,67179,67179,0.572447467,0
1583,Missouri\Stoddard,228568,226734,227781,226698,418278,396346,787,36,226698,226698,0.571969945,1
1691,Nebraska\Greeley,76393,88190,75780,87940,127554,154354,613,250,87940,87940,0.569729324,1
173,California\Contra Costa,27421,27272,22476,26476,35853,46531,4945,796,26476,26476,0.568997013,1
108,Arkansas\Crittenden,138102,173321,138102,173321,278751,306536,0,0,173321,173321,0.565418091,1
1658,Nebraska\Boone,173086,184700,171636,183038,282746,326916,1450,1662,183038,183038,0.559893061,1
2817,Utah\Utah,77457,75167,56762,61273,117766,109540,20695,13894,61273,61273,0.559366441,1
558,Idaho\Fremont,101849,124845,92522,115695,175719,207777,9327,9150,115695,115695,0.55682294,1
1624,Montana\Madison,104948,111891,76054,80622,152196,144938,28894,31269,80622,80622,0.556251639,1
2223,Oregon\Crook,73242,61941,39821,31651,79018,56950,33421,30290,31651,31651,0.555768218,1
1734,Nebraska\Sherman,72256,71109,71878,70878,125561,127686,378,231,70878,70878,0.555096095,1
3126,Wyoming\Uinta,104813,70144,52736,38098,70210,68719,52077,32046,38098,38098,0.554402712,1
2640,Texas\Hartley,171717,155479,167182,149707,345221,270286,4535,5772,149707,149707,0.553883664,1
1758,Nevada\Nye,21510,20017,13613,14581,28080,26354,7897,5436,14581,14581,0.553274645,1
1750,Nevada\Elko,182233,132213,119747,94241,190934,170419,62486,37972,94241,94241,0.552995851,1
1814,New Mexico\Luna,23221,20558,21503,0,42794,37210,1718,0,20558,20558,0.552485891,0
2802,Utah\Grand,4712,4165,3626,3477,7956,6300,1086,688,3477,3477,0.551904762,1
1723,Nebraska\Platte,208388,194037,207561,193933,355259,351509,827,104,193933,193933,0.551715603,1
1708,Nebraska\Lincoln,322916,239819,318385,237519,527021,432296,4531,2300,237519,237519,0.549436035,1
271,Colorado\Otero,55217,43552,47922,40573,92911,74307,7295,2979,40573,40573,0.546018545,1
1810,New Mexico\Hidalgo,11917,9640,8658,7045,32195,12933,3259,2595,7045,7045,0.544730534,1
467,Georgia\Macon,16905,29335,16067,0,53960,53894,838,0,29335,29335,0.5443092,0
1667,Nebraska\Chase,185274,159692,181062,158150,309580,290647,4212,1542,158150,158150,0.544130853,1
1761,Nevada\Washoe,18659,15397,9266,7472,18973,13737,9393,7925,7472,7472,0.543932445,1
1125,Louisiana\Franklin,93958,88803,91537,87617,232437,162416,2421,1186,87617,87617,0.539460398,1
403,Georgia\Clinch,1819,2922,1760,2899,6021,5397,59,23,2899,2899,0.537150269,1
1673,Nebraska\Custer,333441,261502,328191,259883,574106,484929,5250,1619,259883,259883,0.535919691,1
245,Colorado\Eagle,11128,12743,6451,7983,12331,14914,4677,4760,7983,7983,0.535268875,1
352,Florida\Osceola,31420,29153,0,15877,44457,29700,0,13276,15877,15877,0.534579125,1
1825,New Mexico\Sierra,6701,12416,5004,10358,0,19429,1697,2058,10358,10358,0.533120593,1
1779,New Jersey\Camden,2647,2520,2632,2514,5033,4723,15,6,2514,2514,0.532288799,1
1737,Nebraska\Thayer,131413,135509,130832,135121,266148,253995,581,388,135121,135121,0.531982913,1
213,California\Siskiyou,144112,160033,90488,103638,164392,194828,53624,56395,103638,103638,0.531946127,1
196,California\Orange,8955,8054,0,0,14623,15183,0,0,8054,8054,0.530461701,0
215,California\Sonoma,78265,74969,74628,69207,134418,130632,3637,5762,69207,69207,0.529785964,1
579,Idaho\Valley,22136,26217,2871,4626,11443,8752,19265,21591,4626,4626,0.528564899,1
357,Florida\Putnam,4620,5487,4336,5457,12016,10329,284,30,5457,5457,0.528318327,1
3122,Wyoming\Sheridan,56325,49769,45927,39317,91424,74600,10398,10452,39317,39317,0.527037534,1
536,Idaho,3299889,3365292,2867218,3044510,5918899,5793347,432671,320782,3044510,3044510,0.525518323,1
1780,New Jersey\Cape May,2342,2242,2318,2228,4338,4250,24,14,2228,2228,0.524235294,1
3118,Wyoming\Natrona,40325,28921,28649,22606,49561,43318,11676,6315,22606,22606,0.521861582,1
1469,Mississippi\Tunica,73789,101397,73789,101397,186291,194519,0,0,101397,101397,0.521270416,1
2814,Utah\Summit,23960,20775,14366,13138,30662,25204,9594,7637,13138,13138,0.521266466,1
308,Florida\Brevard,20486,13414,10439,10059,22115,19337,10047,3355,10059,10059,0.520194446,1
2792,Utah,1134144,1104257,787205,853875,1837904,1645898,346939,250382,853875,853875,0.518789743,1
1627,Montana\Missoula,16555,16798,12168,10249,27911,19948,4387,6549,10249,10249,0.513785843,1
1683,Nebraska\Franklin,87295,85752,86517,85416,165034,166249,778,336,85416,85416,0.513783542,1
471,Georgia\Miller,37704,31721,36476,31311,65764,60969,1228,410,31311,31311,0.513556069,1
1424,Mississippi\Humphreys,63331,82735,63331,0,145415,161370,0,0,82735,82735,0.512703724,0
2568,Texas\Cameron,101093,112254,94984,107017,226132,209234,6109,5237,107017,107017,0.511470411,1
1714,Nebraska\Morrill,144581,128633,130961,122575,266348,240452,13620,6058,122575,122575,0.509769102,1
76,Arizona\Cochise,67598,65483,58295,62599,141156,123311,9303,2884,62599,62599,0.507651386,1
2805,Utah\Kane,4315,3953,1645,2255,8691,4456,2670,1698,2255,2255,0.506059246,1
553,Idaho\Clark,32013,29249,29854,26525,45502,52456,2159,2724,26525,26525,0.505661888,1
2818,Utah\Wasatch,17420,12420,8966,8770,13472,17382,8454,3650,8770,8770,0.504544932,1
240,Colorado\Custer,18217,12342,12427,10237,26000,20320,5790,2105,10237,10237,0.50378937,1
3033,Wisconsin\Adams,37563,44297,37187,44099,79563,87541,376,198,44099,44099,0.503752527,1
375,Georgia\Baker,21999,30495,21754,0,51582,60575,245,0,30495,30495,0.503425506,0
2795,Utah\Cache,80236,76289,69534,68936,143716,137212,10702,7353,68936,68936,0.502405037,1
1883,New York\Suffolk,13614,11820,13466,11627,26342,23163,148,193,11627,11627,0.50196434,1
211,California\Shasta,48690,38234,18315,18324,40180,36855,30375,19910,18324,18324,0.497191697,1
1722,Nebraska\Pierce,128897,130027,127131,128997,247215,260567,1766,1030,128997,128997,0.49506269,1
1625,Montana\Meagher,40457,36075,36410,34443,113075,69587,4047,1632,34443,34443,0.49496314,1
2334,South Carolina\Beaufort,2430,3179,2129,0,7447,6434,301,0,3179,3179,0.494093876,0
229,Colorado\Archuleta,14542,24234,3761,6471,18925,13211,10781,17763,6471,6471,0.48981909,1
421,Georgia\Echols,3962,2343,0,2343,6797,4796,0,0,2343,2343,0.48853211,1
303,Florida,1552118,1493320,1424396,1333840,2953340,2744064,127722,159480,1333840,1333840,0.486081957,1
500,Georgia\Sumter,31879,44318,31300,43883,84749,90442,579,435,43883,43883,0.485205988,1
184,California\Lassen,69876,65960,37812,34270,82567,70870,32064,31690,34270,34270,0.483561451,1
1828,New Mexico\Torrance,29942,25015,23909,23106,81130,47866,6033,1909,23106,23106,0.482722601,1
1647,Montana\Treasure,20344,21907,19704,21272,36103,44154,640,635,21272,21272,0.481768356,1
2807,Utah\Morgan,13794,9023,9662,7615,23362,15849,4132,1408,7615,7615,0.480471954,1
1827,New Mexico\Taos,19411,14458,11563,11749,26184,24591,7848,2709,11749,11749,0.477776422,1
189,California\Mendocino,27120,25693,24323,23305,53838,49298,2797,2388,23305,23305,0.472737231,1
1715,Nebraska\Nance,69428,63316,69128,63015,138178,133660,300,301,63015,63015,0.471457429,1
577,Idaho\Teton,52613,56386,46050,40953,85149,87600,6563,15433,40953,40953,0.4675,1
212,California\Sierra,6955,9687,1569,1867,6236,4019,5386,7820,1867,1867,0.464543419,1
2708,Texas\Moore,105088,122366,100273,0,297735,263647,4815,0,122366,122366,0.464128171,0
546,Idaho\Bonneville,155991,133620,147145,129242,298578,278842,8846,4378,129242,129242,0.463495456,1
2234,Oregon\Klamath,226343,159854,116970,94656,168075,205166,109373,65198,94656,94656,0.461362994,1
1697,Nebraska\Holt,339080,280234,332969,276810,667581,600530,6111,3424,276810,276810,0.460942834,1
3082,Wisconsin\Portage,91718,92544,91639,92304,206817,201386,79,240,92304,92304,0.458343678,1
183,California\Lake,13551,13499,13066,13304,28997,29106,485,195,13304,13304,0.457087886,1
580,Idaho\Washington,43917,42733,34168,36096,88383,79516,9749,6637,36096,36096,0.453946376,1
249,Colorado\Garfield,43720,32291,28000,20892,50435,46185,15720,11399,20892,20892,0.452354661,1
336,Florida\Lafayette,7426,10658,6682,10103,17299,22340,744,555,10103,10103,0.452238138,1
268,Colorado\Montezuma,57087,62616,37581,44026,103916,97381,19506,18590,44026,44026,0.452100512,1
1681,Nebraska\Dundy,112676,94837,111203,94239,254230,208550,1473,598,94239,94239,0.451877248,1
1460,Mississippi\Sharkey,47625,61036,47625,61036,156240,135227,0,0,61036,61036,0.451359566,1
2947,Washington\Franklin,217238,207151,211331,203297,467865,452174,5907,3854,203297,203297,0.449599048,1
2608,Texas\El Paso,37788,24914,36963,23928,54101,53280,825,986,23928,23928,0.449099099,1
918,Kansas\Haskell,156478,116650,155610,116227,327599,258979,868,423,116227,116227,0.448789284,1
209,California\Santa Clara,22245,17756,18330,17208,33302,38350,3915,548,17208,17208,0.448709257,1
150,Arkansas\Pulaski,26878,21492,0,0,61928,47918,0,0,21492,21492,0.448516215,0
1617,Montana\Jefferson,26722,29215,17729,22516,54529,50322,8993,6699,22516,22516,0.447438496,1
1703,Nebraska\Keith,116106,115304,115304,113551,260184,253940,802,1753,113551,113551,0.447156809,1
487,Georgia\Pulaski,12696,19545,12636,19545,34044,43712,60,0,19545,19545,0.447131223,1
1146,Louisiana\Richland,77082,85146,73277,84664,203207,189464,3805,482,84664,84664,0.446860617,1
201,California\San Benito,30372,19202,29362,17193,55213,38532,1010,2009,17193,17193,0.446200561,1
261,Colorado\Larimer,63405,52520,56285,47441,119984,106397,7120,5079,47441,47441,0.445886632,1
3110,Wyoming\Converse,37810,31920,29695,27114,60939,60858,8115,4806,27114,27114,0.445528936,1
406,Georgia\Colquitt,44075,47456,43600,47322,114626,106646,475,134,47322,47322,0.443729723,1
3115,Wyoming\Johnson,40296,39953,26015,26507,45029,59805,14281,13446,26507,26507,0.443223811,1
1457,Mississippi\Quitman,49766,68736,49600,68736,176542,155813,166,0,68736,68736,0.441144192,1
1465,Mississippi\Tallahatchie,90602,112414,90602,0,236334,254845,0,0,112414,112414,0.44110734,0
1105,Louisiana\Acadia,72132,82854,69892,82491,185630,187129,2240,363,82491,82491,0.440824244,1
2593,Texas\Dallam,230935,175645,215689,170758,534237,388351,15246,4887,170758,170758,0.439700168,1
1732,Nebraska\Seward,127433,129932,126924,129330,272420,294273,509,602,129330,129330,0.439489861,1
1694,Nebraska\Harlan,107551,93336,106930,93005,224467,211804,621,331,93005,93005,0.439108799,1
362,Florida\Seminole,1829,1180,1074,1062,4461,2419,755,118,1062,1062,0.43902439,1
414,Georgia\Decatur,47946,54744,46648,53884,106518,123602,1298,860,53884,53884,0.435947638,1
2973,Washington\Whatcom,34987,35484,33398,34299,73705,78744,1589,1185,34299,34299,0.435576044,1
540,Idaho\Bear Lake,38741,54502,33106,48599,101510,112489,5635,5903,48599,48599,0.432033354,1
1748,Nevada\Clark,6511,3714,2729,1902,6220,4426,3782,1812,1902,1902,0.429733394,1
1620,Montana\Lewis and Clark,50257,47504,44901,39607,104528,92412,5356,7897,39607,39607,0.428591525,1
1558,Missouri\Pemiscot,121140,122716,0,122716,303961,287458,0,0,122716,122716,0.426900625,1
1423,Mississippi\Holmes,33340,51134,33340,51110,125206,119768,0,24,51110,51110,0.426741701,1
168,California\Alpine,0,239,0,0,490,563,0,0,239,239,0.424511545,0
1655,Nebraska\Arthur,8242,12401,0,12401,30999,29305,0,0,12401,12401,0.423170107,1
3105,Wyoming,1550723,1435710,1025182,1016745,2576017,2418931,525541,418965,1016745,1016745,0.420328236,1
169,California\Amador,10132,11321,5678,6719,15593,16022,4454,4602,6719,6719,0.419360879,1
88,Arizona\Yavapai,7907,7602,3659,4488,25255,10720,4248,3114,4488,4488,0.418656716,1
1712,Nebraska\Madison,107885,122039,106414,121745,257990,290980,1471,294,121745,121745,0.418396453,1
197,California\Placer,30247,20674,15168,14031,50334,33607,15079,6643,14031,14031,0.417502306,1
1811,New Mexico\Lea,39078,51581,32949,48752,128433,117044,6129,2829,48752,48752,0.416527118,1
1659,Nebraska\Box Butte,143021,141563,139451,140045,384396,337490,3570,1518,140045,140045,0.414960443,1
1735,Nebraska\Sioux,51498,39527,48446,38802,119572,93967,3052,725,38802,38802,0.4129322,1
3106,Wyoming\Albany,148819,94448,47401,49712,104894,120437,101418,44736,49712,49712,0.41276352,1
2819,Utah\Washington,13751,14781,7157,8316,42847,20211,6594,6465,8316,8316,0.411459106,1
508,Georgia\Tift,28825,20578,28371,20536,77274,50043,454,42,20536,20536,0.410367084,1
2632,Texas\Hale,243491,202238,234871,196146,462349,479748,8620,6092,196146,196146,0.408852147,1
2796,Utah\Carbon,14837,11128,7734,8550,22781,20919,7103,2578,8550,8550,0.408719346,1
278,Colorado\Rio Blanco,22992,25647,16188,17446,55197,42747,6804,8201,17446,17446,0.408122207,1
337,Florida\Lake,15013,15163,14450,14673,34681,36001,563,490,14673,14673,0.407572012,1
1744,Nebraska\Wheeler,44072,39363,42331,36954,113156,90905,1741,2409,36954,36954,0.406512293,1
972,Kansas\Stevens,167062,145209,165974,143855,402149,354277,1088,1354,143855,143855,0.406052326,1
533,Hawaii\Honolulu,8437,10776,0,8942,18896,22200,0,1834,8942,8942,0.402792793,1
3113,Wyoming\Goshen,111487,109171,95143,96624,286219,241491,16344,12547,96624,96624,0.40011429,1
557,Idaho\Franklin,49448,61169,44011,56292,131797,140805,5437,4877,56292,56292,0.399786939,1
513,Georgia\Turner,22175,19105,22095,18991,65755,47504,80,114,18991,18991,0.399776861,1
2810,Utah\Salt Lake,9872,6830,5661,5401,29127,13534,4211,1429,5401,5401,0.399069011,1
314,Florida\Collier,31361,26412,31087,26311,69862,66948,274,101,26311,26311,0.393006513,1
175,California\El Dorado,9892,6811,4614,4351,15275,11130,5278,2460,4351,4351,0.390925427,1
383,Georgia\Bleckley,17543,13002,17431,0,57014,33293,112,0,13002,13002,0.390532544,0
1106,Louisiana\Allen,11620,18399,11593,0,48402,47156,27,0,18399,18399,0.390173043,0
198,California\Plumas,20229,19142,6717,10105,18487,25970,13512,9037,10105,10105,0.389102811,1
171,California\Calaveras,4888,4523,2061,2356,12097,6059,2827,2167,2356,2356,0.388843043,1
447,Georgia\Houston,4479,8985,4370,0,20327,23113,109,0,8985,8985,0.388742266,0
1600,Montana\Carbon,73796,72781,52033,53062,138125,136674,21763,19719,53062,53062,0.388237704,1
248,Colorado\Fremont,11845,8449,9220,6861,25569,17683,2625,1588,6861,6861,0.387999774,1
1781,New Jersey\Cumberland,18357,19320,18197,19281,52330,49699,160,39,19281,19281,0.387955492,1
1239,Michigan\Cass,38985,57619,38925,57365,151852,147980,60,254,57365,57365,0.387653737,1
1679,Nebraska\Dodge,116051,117968,115903,117844,305051,304968,148,124,117844,117844,0.386414312,1
2944,Washington\Cowlitz,2980,7556,2627,7199,10933,18633,353,357,7199,7199,0.386357538,1
1166,Louisiana\West Carroll,36167,45232,35553,44694,113715,115890,614,538,44694,44694,0.385658814,1
1124,Louisiana\Evangeline,37208,40070,36281,0,105822,103929,927,0,40070,40070,0.385551675,0
644,Illinois\Mason,100521,102317,100490,0,251297,265513,31,0,102317,102317,0.385355896,0
302,Delaware\Sussex,72785,90809,72349,90591,234324,235681,436,218,90591,90591,0.384379734,1
2240,Oregon\Marion,96382,84916,92817,82096,225094,213788,3565,2820,82096,82096,0.384006586,1
2247,Oregon\Union,63266,49049,52566,45457,141400,119224,10700,3592,45457,45457,0.381273905,1
2620,Texas\Gaines,242624,226992,236195,217472,641654,570552,6429,9520,217472,217472,0.381160701,1
1652,Nebraska,8558559,8296573,8448373,8225973,21486025,21597393,110186,70600,8225973,8225973,0.380878053,1
1629,Montana\Park,51859,57112,38588,41818,110188,110059,13271,15294,41818,41818,0.37995984,1
3121,Wyoming\Platte,75712,72226,58781,56003,196159,147904,16931,16223,56003,56003,0.378644256,1
2941,Washington\Clallam,4500,4164,3164,3072,8750,8124,1336,1092,3072,3072,0.378138848,1
527,Georgia\Wilcox,21429,28416,20996,28416,58141,75190,433,0,28416,28416,0.377922596,1
2815,Utah\Tooele,24538,22958,9988,15180,23370,40184,14550,7778,15180,15180,0.377762293,1
1580,Missouri\Scott,67332,72400,67249,0,203017,192796,83,0,72400,72400,0.375526463,0
2652,Texas\Hudspeth,27346,18130,26127,0,106452,48285,1219,0,18130,18130,0.375478927,0
289,Colorado\Yuma,263820,232998,258083,227836,697792,607155,5737,5162,227836,227836,0.375251789,1
167,California\Alameda,9687,8893,8456,7635,30549,20347,1231,1258,7635,7635,0.375239593,1
122,Arkansas\Independence,30310,32697,0,32674,99622,87208,0,23,32674,32674,0.374667462,1
2645,Texas\Hidalgo,169322,183643,158902,174069,404321,465563,10420,9574,174069,174069,0.373889248,1
1709,Nebraska\Logan,24756,22968,24247,0,69963,61448,509,0,22968,22968,0.373779456,0
1798,New Mexico\Bernalillo,7757,5283,7245,4646,22769,12452,512,637,4646,4646,0.373112753,1
1666,Nebraska\Cedar,112123,139048,111778,138586,365996,371749,345,462,138586,138586,0.372794547,1
2572,Texas\Castro,213277,154877,200956,153144,434559,410979,12321,1733,153144,153144,0.372632178,1
2804,Utah\Juab,27118,20454,21172,17818,65702,47866,5946,2636,17818,17818,0.372247524,1
1547,Missouri\Mississippi,80181,86459,0,86459,249396,232336,0,0,86459,86459,0.372129158,1
2619,Texas\Frio,42895,60494,36084,56750,151274,152921,6811,3744,56750,56750,0.37110665,1
2960,Washington\Okanogan,51582,51723,44711,47740,127148,129232,6871,3983,47740,47740,0.369413148,1
1640,Montana\Sanders,16864,17485,11576,12684,38472,34375,5288,4801,12684,12684,0.368989091,1
1738,Nebraska\Thomas,3208,2944,0,0,10180,8007,0,0,2944,2944,0.367678282,0
1791,New Jersey\Passaic,107,91,107,91,419,248,0,0,91,91,0.366935484,1
3102,Wisconsin\Waushara,35560,39904,35517,39812,108934,108688,43,92,39812,39812,0.366296187,1
195,California\Nevada,7223,5314,2367,1226,7301,3349,4856,4088,1226,1226,0.366079427,1
2939,Washington\Benton,181585,197305,170308,189833,476548,519123,11277,7472,189833,189833,0.365680195,1
401,Georgia\Clay,9417,6825,0,6825,23756,18729,0,0,6825,6825,0.364408137,1
1728,Nebraska\Saline,81850,108115,81464,0,241911,296697,386,0,108115,108115,0.364395326,0
2950,Washington\Grays Harbor,4906,8635,4459,8268,24070,22786,447,367,8268,8268,0.362854384,1
2748,Texas\Sherman,157563,126648,154118,122775,392691,339142,3445,3873,122775,122775,0.3620165,1
2591,Texas\Crosby,109968,111723,108149,108260,289016,299594,1819,3463,108260,108260,0.361355701,1
1821,New Mexico\Sandoval,8993,9425,5538,6418,22804,17785,3455,3007,6418,6418,0.360865898,1
1664,Nebraska\Butler,117973,110839,117566,110584,295608,306621,407,255,110584,110584,0.360653706,1
367,Florida\Volusia,9068,8996,8224,8423,18328,23360,844,573,8423,8423,0.36057363,1
219,California\Trinity,1384,1614,704,751,2985,2084,680,863,751,751,0.360364683,1
1131,Louisiana\Jefferson Davis,79094,67716,76746,67055,227369,186479,2348,661,67055,67055,0.359584725,1
253,Colorado\Hinsdale,1887,2432,387,407,787,1132,1500,2025,407,407,0.359540636,1
2654,Texas\Hutchinson,33022,35107,30812,0,144105,97808,2210,0,35107,35107,0.358937919,0
127,Arkansas\Lafayette,16761,21688,16761,0,55243,60794,0,0,21688,21688,0.356745731,0
260,Colorado\La Plata,66025,61700,28704,30640,76772,85890,37321,31060,30640,30640,0.356735359,1
1661,Nebraska\Brown,51923,40156,50608,38930,114848,109405,1315,1226,38930,38930,0.355833828,1
2689,Texas\Lubbock,159459,155462,156273,150512,415814,423830,3186,4950,150512,150512,0.355123517,1
2677,Texas\Lamb,234848,179531,226165,165536,514985,469135,8683,13995,165536,165536,0.352853656,1
506,Georgia\Terrell,29111,25829,0,0,80125,73208,0,0,25829,25829,0.352816632,0
1711,Nebraska\McPherson,9675,7113,8761,0,34854,20167,914,0,7113,7113,0.352704914,0
457,Georgia\Lanier,8434,6925,0,0,21779,19733,0,0,6925,6925,0.350934982,0
1137,Louisiana\Madison,35309,63085,35309,0,195596,180692,0,0,63085,63085,0.349130011,0
420,Georgia\Early,33053,32700,32496,0,99495,93765,557,0,32700,32700,0.348744201,0
1829,New Mexico\Union,47027,26014,45044,22981,122555,66126,1983,3033,22981,22981,0.347533497,1
1264,Michigan\Kalamazoo,31314,39054,31067,0,115979,112853,247,0,39054,39054,0.346060805,0
2383,South Dakota\Butte,47701,45409,43986,40255,163375,116836,3715,5154,40255,40255,0.344542778,1
514,Georgia\Twiggs,2115,5116,1995,4916,13501,14276,120,200,4916,4916,0.344354161,1
937,Kansas\Meade,105194,129534,105014,127747,380498,372159,180,1787,127747,127747,0.343259198,1
390,Georgia\Calhoun,30346,21054,0,21054,67031,61407,0,0,21054,21054,0.342859935,1
2722,Texas\Parmer,174990,162971,160728,152332,437153,444730,14262,10639,152332,152332,0.342526926,1
1700,Nebraska\Jefferson,80979,92769,80284,92664,232700,270681,695,105,92664,92664,0.342336551,1
2699,Texas\Maverick,13044,12960,4218,4735,30800,13849,8826,8225,4735,4735,0.341901942,1
530,Georgia\Worth,30187,47180,29686,46978,111072,137404,501,202,46978,46978,0.341896888,1
3096,Wisconsin\Vilas,1044,950,1044,950,3573,2805,0,0,950,950,0.338680927,1
1184,Maine\Washington,4605,12079,0,0,35655,35706,0,0,12079,12079,0.338290483,0
326,Florida\Hamilton,5518,9548,5336,0,20047,28351,182,0,9548,9548,0.336778244,0
3114,Wyoming\Hot Springs,21379,12612,10870,9457,40456,28114,10509,3155,9457,9457,0.336380451,1
491,Georgia\Randolph,15753,21951,0,21741,55520,64683,0,210,21741,21741,0.336116136,1
1380,Minnesota\Sherburne,30668,29730,30209,29722,78453,88663,459,8,29722,29722,0.335224389,1
538,Idaho\Adams,24914,19038,6651,6653,27759,19849,18263,12385,6653,6653,0.335180614,1
2769,Texas\Uvalde,45344,49531,36855,46762,131420,139831,8489,2769,46762,46762,0.334417976,1
410,Georgia\Crawford,4458,4665,0,0,15076,13960,0,0,4665,4665,0.334169054,0
331,Florida\Hillsborough,29923,26096,28747,25297,86367,75764,1176,799,25297,25297,0.333892086,1
575,Idaho\Power,113983,120949,109614,120162,351087,361680,4369,787,120162,120162,0.332232913,1
1875,New York\Rockland,37,73,37,73,128,220,0,0,73,73,0.331818182,1
448,Georgia\Irwin,30577,31629,29657,31629,88253,95710,920,0,31629,31629,0.330467036,1
2635,Texas\Hansford,100702,98127,93681,96867,331504,294447,7021,1260,96867,96867,0.328979409,1
1397,Mississippi,1368661,1651978,1364157,1648601,5530825,5075579,4504,3377,1648601,1648601,0.32481043,1
2788,Texas\Yoakum,101067,90426,100392,86256,281872,265858,675,4170,86256,86256,0.324443876,1
317,Florida\Dixie,2957,3439,2912,0,7647,10604,45,0,3439,3439,0.324311581,0
901,Kansas\Edwards,106391,92332,105158,0,328015,284890,1233,0,92332,92332,0.32409702,0
2700,Texas\Medina,41210,51418,34380,45724,173541,141396,6830,5694,45724,45724,0.323375484,1
417,Georgia\Dooly,37215,28005,0,0,106558,86635,0,0,28005,28005,0.323252727,0
361,Florida\Sarasota,2348,2023,2190,1503,8664,4670,158,520,1503,1503,0.321841542,1
270,Colorado\Morgan,94611,100881,90748,97487,322969,303602,3863,3394,97487,97487,0.32110131,1
509,Georgia\Toombs,10749,9869,0,9774,30649,30553,0,95,9774,9774,0.319903119,1
2248,Oregon\Wallowa,44775,37971,31083,28289,96028,88520,13692,9682,28289,28289,0.319577497,1
453,Georgia\Jenkins,9978,14150,0,14090,41973,44094,0,60,14090,14090,0.319544609,1
1161,Louisiana\Vermilion,58930,59172,50942,54901,184289,171871,7988,4271,54901,54901,0.319431434,1
2304,Pennsylvania\Philadelphia,0,21,0,0,150,66,0,0,21,21,0.318181818,0
965,Kansas\Seward,114480,100953,113405,97893,293292,307674,1075,3060,97893,97893,0.318171181,1
459,Georgia\Lee,15757,16877,15284,16773,50228,52724,473,104,16773,16773,0.318128367,1
1688,Nebraska\Garfield,20620,22477,19003,0,78080,70672,1617,0,22477,22477,0.318046751,0
364,Florida\Suwannee,20096,27808,18763,26648,68157,84084,1333,1160,26648,26648,0.316921174,1
288,Colorado\Weld,327836,299892,303373,268844,987892,850179,24463,31048,268844,268844,0.316220467,1
2326,Rhode Island\Washington,2625,2621,2610,2598,9372,8232,15,23,2598,2598,0.315597668,1
2222,Oregon\Coos,10781,11231,6561,6586,26785,20938,4220,4645,6586,6586,0.314547712,1
463,Georgia\Lowndes,4169,8001,3800,7950,27761,25389,369,51,7950,7950,0.313127732,1
1743,Nebraska\Webster,62363,55006,61182,0,177974,177770,1181,0,55006,55006,0.309422287,0
1284,Michigan\Montcalm,40340,55870,40288,55789,189934,181062,52,81,55789,55789,0.308120975,1
1140,Louisiana\Orleans,0,8,0,8,0,26,0,0,8,8,0.307692308,1
1611,Montana\Gallatin,81651,79100,68404,69172,283749,225062,13247,9928,69172,69172,0.30734642,1
206,California\San Luis Obispo,98898,81636,78279,77716,299572,255378,20619,3920,77716,77716,0.304317521,1
1684,Nebraska\Frontier,53702,53286,53308,52763,189835,174670,394,523,52763,52763,0.30207248,1
339,Florida\Leon,1467,2010,1406,1978,12992,6563,61,32,1978,1978,0.301386561,1
1695,Nebraska\Hayes,65655,57112,64955,55889,210258,186112,700,1223,55889,55889,0.30029767,1
388,Georgia\Burke,17693,27458,17003,26573,111059,88719,690,885,26573,26573,0.299518705,1
1797,New Mexico,830048,680318,648272,590104,2334018,1976689,181776,90214,590104,590104,0.298531534,1
350,Florida\Okeechobee,20545,19443,17637,15537,40902,52142,2908,3906,15537,15537,0.297974761,1
911,Kansas\Grant,87416,88677,87192,88677,271968,298194,224,0,88677,88677,0.297380229,1
78,Arizona\Gila,3230,838,947,0,3738,2818,2283,0,838,838,0.297374024,0
1671,Nebraska\Colfax,62481,66796,0,66627,187650,224946,0,169,66627,66627,0.296191086,1
1720,Nebraska\Perkins,133393,127855,132143,127492,444497,432139,1250,363,127492,127492,0.295025443,1
408,Georgia\Cook,10845,14816,0,13018,38431,44174,0,1798,13018,13018,0.294698239,1
280,Colorado\Routt,43527,46568,27270,34301,129874,117310,16257,12267,34301,34301,0.292396215,1
912,Kansas\Gray,137080,124200,133184,122760,425900,420910,3896,1440,122760,122760,0.291653798,1
1371,Minnesota\Ramsey,139,116,139,116,294,399,0,0,116,116,0.290726817,1
254,Colorado\Huerfano,13889,11651,8925,7292,35769,25086,4964,4359,7292,7292,0.290680061,1
299,Delaware,104562,127272,104063,127007,432773,439157,499,265,127007,127007,0.289206366,1
178,California\Humboldt,17490,17051,7383,6016,33867,20936,10107,11035,6016,6016,0.28735193,1
2224,Oregon\Curry,2590,3217,1132,1494,10711,5207,1458,1723,1494,1494,0.286921452,1
2346,South Carolina\Edgefield,4986,5977,4958,5977,25836,20886,28,0,5977,5977,0.286172556,1
466,Georgia\McIntosh,35,279,0,0,2596,977,0,0,279,279,0.285568066,0
416,Georgia\Dodge,13510,7902,13118,0,46563,27702,392,0,7902,7902,0.285250162,0
347,Florida\Monroe,30,37,30,37,156,130,0,0,37,37,0.284615385,1
1819,New Mexico\Rio Arriba,30752,29199,18768,18994,80301,66760,11984,10205,18994,18994,0.284511684,1
1338,Minnesota\Hubbard,22228,19610,0,0,70809,68940,0,0,19610,19610,0.284450247,0
1717,Nebraska\Nuckolls,61115,65246,61086,0,205197,230387,29,0,65246,65246,0.283201743,0
381,Georgia\Berrien,14482,21607,14023,0,59878,76368,459,0,21607,21607,0.282932642,0
452,Georgia\Jefferson,14587,22266,0,21123,61702,74745,0,1143,21123,21123,0.282600843,1
539,Idaho\Bannock,39296,52557,32972,46333,184958,164069,6324,6224,46333,46333,0.282399478,1
503,Georgia\Tattnall,12510,13840,12247,0,73482,49194,263,0,13840,13840,0.281335122,0
551,Idaho\Caribou,68273,66036,57270,60504,228991,215399,11003,5532,60504,60504,0.280892669,1
1783,New Jersey\Gloucester,12891,9009,12751,8969,34709,31997,140,40,8969,8969,0.280307529,1
1710,Nebraska\Loup,10375,8222,10327,0,35265,29347,48,0,8222,8222,0.280164923,0
2965,Washington\Skagit,16286,19239,15821,18683,69810,66765,465,556,18683,18683,0.279832247,1
1816,New Mexico\Mora,12742,7589,8007,3719,52729,13321,4735,3870,3719,3719,0.279183245,1
163,Arkansas\White,43243,39358,0,38552,202225,138293,0,806,38552,38552,0.278770437,1
474,Georgia\Montgomery,2581,5011,2561,0,17351,18114,20,0,5011,5011,0.276636855,0
207,California\San Mateo,3579,2822,3320,2341,10377,8477,259,481,2341,2341,0.276159019,1
504,Georgia\Taylor,4364,5970,0,0,32591,21664,0,0,5970,5970,0.275572378,0
905,Kansas\Finney,179290,186583,175659,184037,567712,670412,3631,2546,184037,184037,0.274513284,1
411,Georgia\Crisp,17330,22262,17245,22262,49246,81885,85,0,22262,22262,0.271869085,1
1305,Michigan\Van Buren,30444,34046,30258,34003,135040,125089,186,43,34003,34003,0.271830457,1
2251,Oregon\Wheeler,14083,10357,6766,6743,56261,24833,7317,3614,6743,6743,0.271533846,1
2216,Oregon,1845194,1629735,1333741,1266256,5010408,4690420,511453,363479,1266256,1266256,0.269966442,1
3066,Wisconsin\Langlade,17465,19717,0,19717,78258,73093,0,0,19717,19717,0.269752233,1
1644,Montana\Sweet Grass,43241,35770,28781,21184,98005,78718,14460,14586,21184,21184,0.269112528,1
323,Florida\Gilchrist,7808,12563,7483,11772,32846,43744,325,791,11772,11772,0.269111192,1
505,Georgia\Telfair,7325,4030,7027,3707,24224,13784,298,323,3707,3707,0.268934997,1
1571,Missouri\Ripley,8551,12087,8425,0,47583,45129,126,0,12087,12087,0.267832214,0
283,Colorado\San Miguel,12694,12674,3627,3908,17807,14610,9067,8766,3908,3908,0.267488022,1
2794,Utah\Box Elder,112113,102925,96944,87878,327695,328644,15169,15047,87878,87878,0.267395723,1
72,Alaska\Juneau,12,21,12,21,41,79,0,0,21,21,0.265822785,1
371,Georgia,1017773,1125355,987160,1112359,4478168,4190918,30613,12996,1112359,1112359,0.265421323,1
519,Georgia\Ware,2545,4867,2521,0,18896,18506,24,0,4867,4867,0.262995785,0
2228,Oregon\Grant,40751,31583,27412,25317,68486,96396,13339,6266,25317,25317,0.262635379,1
431,Georgia\Fulton,268,840,241,788,3644,3012,27,52,788,788,0.261620186,1
1328,Minnesota\Dakota,57076,50372,57045,0,217266,192659,31,0,50372,50372,0.261456771,0
1425,Mississippi\Issaquena,15282,19661,15282,19661,79130,75243,0,0,19661,19661,0.261300054,1
2242,Oregon\Multnomah,7029,4637,6703,4554,19997,17441,326,83,4554,4554,0.261108881,1
380,Georgia\Ben Hill,7966,6935,7686,6899,36580,26457,280,36,6899,6899,0.260762747,1
75,Arizona\Apache,9343,9776,5674,6888,27455,26467,3669,2888,6888,6888,0.260248611,1
730,Indiana\LaPorte,47849,54378,0,54331,231890,209291,0,47,54331,54331,0.259595491,1
970,Kansas\Stafford,104211,103434,103966,102934,386084,396537,245,500,102934,102934,0.259582334,1
1802,New Mexico\Colfax,21091,10328,13025,6175,25199,23854,8066,4153,6175,6175,0.258866437,1
405,Georgia\Coffee,17971,22811,16326,22517,98913,86997,1645,294,22517,22517,0.258825017,1
231,Colorado\Bent,50450,31472,46795,27459,185702,107114,3655,4013,27459,27459,0.256353044,1
1730,Nebraska\Saunders,93428,105618,93211,105464,359915,412033,217,154,105464,105464,0.255960081,1
1141,Louisiana\Ouachita,7325,12123,7307,0,50479,47443,18,0,12123,12123,0.255527686,0
1680,Nebraska\Douglas,13804,19770,0,19442,72859,76250,0,328,19442,19442,0.254977049,1
2966,Washington\Skamania,277,352,249,332,1610,1312,28,20,332,332,0.25304878,1
1104,Louisiana,954353,1092881,910458,1078596,4691344,4275637,43895,14285,1078596,1078596,0.252265569,1
385,Georgia\Brooks,19064,19692,17009,19331,91775,77047,2055,361,19331,19331,0.250898802,1
2245,Oregon\Tillamook,7475,7137,2686,3628,17720,14482,4789,3509,3628,3628,0.250517884,1
2647,Texas\Hockley,132284,106915,125847,100152,411374,400120,6437,6763,100152,100152,0.250304909,1
2760,Texas\Terry,142010,98249,136185,93922,419266,376970,5825,4327,93922,93922,0.2491498,1
309,Florida\Broward,1651,1828,1538,1069,4853,4292,113,759,1069,1069,0.249068034,1
354,Florida\Pasco,10599,6594,9798,6146,37757,24708,801,448,6146,6146,0.248745346,1
1778,New Jersey\Burlington,12620,13123,12518,12956,53650,52286,102,167,12956,12956,0.247790996,1
2729,Texas\Reagan,8545,12108,8492,11536,57947,46654,53,572,11536,11536,0.247267115,1
3076,Wisconsin\Oneida,2709,2965,0,2965,13890,12095,0,0,2965,2965,0.245142621,1
1195,Maryland\Dorchester,20973,22402,20880,0,94901,91954,93,0,22402,22402,0.243621811,0
531,Hawaii,58635,81813,47825,41960,177626,174042,10810,39853,41960,41960,0.241091231,1
2563,Texas\Burleson,14480,19598,13995,19513,92312,81183,485,85,19513,19513,0.240358203,1
1727,Nebraska\Rock,43586,36290,42471,35265,154635,146894,1115,1025,35265,35265,0.240071072,1
2614,Texas\Floyd,129798,96748,128464,94226,420694,392903,1334,2522,94226,94226,0.239820006,1
1158,Louisiana\Tensas,26998,40270,26978,0,188771,168156,20,0,40270,40270,0.239480007,0
2577,Texas\Cochran,82451,67830,81074,64184,305311,268528,1377,3646,64184,64184,0.239021629,1
484,Georgia\Pierce,8280,10795,7993,10713,34871,44852,287,82,10713,10713,0.238852225,1
953,Kansas\Pratt,71234,86248,69776,84943,321131,356801,1458,1305,84943,84943,0.238068279,1
2250,Oregon\Washington,26232,20323,25107,19471,92624,82014,1125,852,19471,19471,0.237410686,1
273,Colorado\Park,9933,3761,4249,2406,55900,10151,5684,1355,2406,2406,0.237020983,1
1389,Minnesota\Wadena,18406,19958,18192,19635,81342,83490,214,323,19635,19635,0.235177866,1
1685,Nebraska\Furnas,51894,66352,51717,0,276450,282694,177,0,66352,66352,0.234713153,0
77,Arizona\Coconino,2192,1946,839,0,20483,8322,1353,0,1946,1946,0.23383802,0
2219,Oregon\Clackamas,27812,22150,24163,19541,104618,84022,3649,2609,19541,19541,0.232570041,1
1610,Montana\Flathead,23279,18193,20002,16564,88547,71306,3277,1629,16564,16564,0.232294618,1
1599,Montana\Broadwater,44148,39566,37099,34915,139024,151319,7049,4651,34915,34915,0.230737713,1
2336,South Carolina\Calhoun,10030,14936,9340,14806,60867,64484,690,130,14806,14806,0.229607344,1
1687,Nebraska\Garden,44854,35725,43104,34175,187960,149378,1750,1550,34175,34175,0.228782016,1
1479,Mississippi\Yazoo,37541,44768,0,44643,194323,195350,0,125,44643,44643,0.228528283,1
1622,Montana\Lincoln,4257,3512,2849,2236,16570,9800,1408,1276,2236,2236,0.228163265,1
1113,Louisiana\Caddo,9698,13504,0,13322,77514,58556,0,182,13322,13322,0.22750871,1
1451,Mississippi\Panola,25083,30365,25083,30365,138806,134806,0,0,30365,30365,0.225249618,1
1237,Michigan\Branch,42923,44528,42818,44521,202382,197706,105,7,44521,44521,0.225187905,1
2952,Washington\Jefferson,628,1179,440,937,3833,4173,188,242,937,937,0.224538701,1
2067,Ohio\Cuyahoga,78,143,73,143,1219,637,5,0,143,143,0.224489796,1
499,Georgia\Stewart,384,4403,0,4403,11721,19678,0,0,4403,4403,0.223752414,1
1792,New Jersey\Salem,18001,18087,17782,18037,78055,81213,219,50,18037,18037,0.222094985,1
759,Indiana\Starke,17299,25597,0,0,132761,115367,0,0,25597,25597,0.22187454,0
1191,Maryland\Caroline,24596,27033,0,26918,107137,121386,0,115,26918,26918,0.221755392,1
451,Georgia\Jeff Davis,9259,9834,0,9834,38058,44546,0,0,9834,9834,0.220760562,1
2208,Oklahoma\Texas,156026,152982,146662,149306,656356,678815,9364,3676,149306,149306,0.219950944,1
524,Georgia\Wheeler,4128,2541,4058,2541,17482,11554,70,0,2541,2541,0.219923836,1
1725,Nebraska\Red Willow,55075,53127,54589,0,247135,241601,486,0,53127,53127,0.219895613,0
967,Kansas\Sheridan,78671,79320,0,79080,369269,363453,0,240,79080,79080,0.217579715,1
2092,Ohio\Lake,2180,1871,2180,1862,10126,8561,0,9,1862,1862,0.217497956,1
2359,South Carolina\Lexington,11078,10741,10778,10627,45913,48950,300,114,10627,10627,0.217099081,1
1733,Nebraska\Sheridan,56977,60699,55580,59776,285985,275463,1397,923,59776,59776,0.21700192,1
523,Georgia\Webster,3296,4806,3123,0,26354,22216,173,0,4806,4806,0.216330573,0
300,Delaware\Kent,29066,31833,0,31794,146536,147402,0,39,31794,31794,0.215695852,1
1674,Nebraska\Dakota,20414,29301,20414,0,147766,135963,0,0,29301,29301,0.21550716,0
1787,New Jersey\Middlesex,2655,2654,0,2643,12899,12334,0,11,2643,2643,0.214285714,1
926,Kansas\Kiowa,38850,49896,38360,0,228184,233184,490,0,49896,49896,0.213976945,0
2668,Texas\Kenedy,407,660,407,0,2797,3102,0,0,660,660,0.212765957,0
1405,Mississippi\Carroll,8758,12327,0,12287,63994,57773,0,40,12287,12287,0.212677202,1
1807,New Mexico\Grant,3405,3978,531,1784,8814,8390,2874,2194,1784,1784,0.212634088,1
1414,Mississippi\DeSoto,21956,17214,0,0,94040,81159,0,0,17214,17214,0.21210217,0
2226,Oregon\Douglas,16422,14583,10377,10440,73559,49222,6045,4143,10440,10440,0.21210028,1
84,Arizona\Navajo,8561,6540,5298,4246,16867,20050,3263,2294,4246,4246,0.211770574,1
2963,Washington\Pierce,4453,2834,3451,2438,17319,11524,1002,396,2438,2438,0.211558487,1
342,Florida\Madison,3119,8067,2955,0,40327,38497,164,0,8067,8067,0.209548796,0
482,Georgia\Peach,5635,4681,0,4653,23530,22248,0,28,4653,4653,0.209142395,1
1742,Nebraska\Wayne,42736,49807,42513,49804,238313,238394,223,3,49804,49804,0.208914654,1
1604,Montana\Custer,31352,30315,27587,29068,186726,139279,3765,1247,29068,29068,0.208703394,1
1790,New Jersey\Ocean,1090,658,1071,606,4423,2921,19,52,606,606,0.207463198,1
425,Georgia\Evans,2802,3038,2527,0,23428,14663,275,0,3038,3038,0.207188161,0
2602,Texas\Donley,16851,14939,15293,14049,83727,67970,1558,890,14049,14049,0.20669413,1
549,Idaho\Camas,16547,20384,12683,17070,81416,82688,3864,3314,17070,17070,0.206438661,1
2936,Washington,1735917,1633571,1589538,1550138,7609210,7526742,146379,83433,1550138,1550138,0.205950729,1
2723,Texas\Pecos,17255,13918,14809,13081,101383,63668,2446,837,13081,13081,0.20545643,1
1704,Nebraska\Keya Paha,18124,20138,0,20024,101405,98043,0,114,20024,20024,0.204236916,1
2791,Texas\Zavala,26117,29384,18743,19555,101534,95980,7374,9829,19555,19555,0.203740363,1
1116,Louisiana\Cameron,12112,11513,6006,11263,55369,55311,6106,250,11263,11263,0.203630381,1
340,Florida\Levy,14488,13661,11996,12167,73176,59835,2492,1494,12167,12167,0.203342525,1
844,Iowa\Monona,65738,61125,0,61125,346530,300638,0,0,61125,61125,0.203317611,1
2671,Texas\Kimble,2477,8506,2139,3153,35921,15535,338,5353,3153,3153,0.202961056,1
1117,Louisiana\Catahoula,22183,33695,22066,0,172809,166155,117,0,33695,33695,0.202792573,0
755,Indiana\St. Joseph,25010,27580,24988,27561,163596,136304,22,19,27561,27561,0.20220243,1
322,Florida\Gadsden,2209,2650,2171,2607,15152,13068,38,43,2607,2607,0.199494949,1
1698,Nebraska\Hooker,2995,3124,0,0,22059,15667,0,0,3124,3124,0.199400013,0
2252,Oregon\Yamhill,26783,22064,24864,21611,114829,108527,1919,453,21611,21611,0.19913017,1
318,Florida\Duval,2024,1115,1947,1099,5680,5546,77,16,1099,1099,0.198160837,1
225,Colorado,2867957,2516785,2296765,2110131,11483936,10649747,571192,406654,2110131,2110131,0.198139073,1
1657,Nebraska\Blaine,13650,6977,12981,6445,43211,32578,669,532,6445,6445,0.197832893,1
2489,Tennessee\Lake,5494,15447,5494,15447,81149,78116,0,0,15447,15447,0.19774438,1
1939,North Carolina\Henderson,1818,3431,0,3420,18956,17363,0,11,3420,3420,0.19697057,1
950,Kansas\Pawnee,61632,78490,0,0,380858,398498,0,0,78490,78490,0.196964602,0
971,Kansas\Stanton,84366,76651,0,0,358273,390581,0,0,76651,76651,0.196248665,0
2243,Oregon\Polk,16651,20432,15538,19809,120116,101014,1113,623,19809,19809,0.19610153,1
274,Colorado\Phillips,63734,72945,63254,72656,355613,370779,480,289,72656,72656,0.195955003,1
564,Idaho\Kootenai,11035,13778,9987,12569,71166,64318,1048,1209,12569,12569,0.195419634,1
2332,South Carolina\Bamberg,5486,7428,5074,7121,53888,36568,412,307,7121,7121,0.1947331,1
1706,Nebraska\Knox,51751,63949,50631,63398,273593,326636,1120,551,63398,63398,0.194093731,1
3119,Wyoming\Niobrara,12311,14572,10036,0,52784,75354,2275,0,14572,14572,0.193380577,0
2768,Texas\Upton,7286,8876,0,0,31974,46082,0,0,8876,8876,0.192613168,0
979,Kansas\Wichita,50851,67539,0,0,398212,351176,0,0,67539,67539,0.192322368,0
1775,New Jersey,95277,88376,94121,87770,488697,456751,1156,606,87770,87770,0.192161594,1
1286,Michigan\Muskegon,9774,9451,9580,9397,58144,48974,194,54,9397,9397,0.191877323,1
2961,Washington\Pacific,2299,2487,2170,0,15042,12962,129,0,2487,2487,0.191868539,0
1777,New Jersey\Bergen,196,94,173,94,561,494,23,0,94,94,0.190283401,1
292,Connecticut\Hartford,5671,4948,5630,4878,29617,25679,41,70,4878,4878,0.189960668,1
373,Georgia\Atkinson,5617,6606,5094,0,28398,35131,523,0,6606,6606,0.188039054,0
2624,Texas\Glasscock,29514,25291,29395,0,126695,134675,119,0,25291,25291,0.187792835,0
522,Georgia\Wayne,4614,6630,4570,6630,24064,35555,44,0,6630,6630,0.186471664,1
143,Arkansas\Perry,5367,4704,0,0,32979,25432,0,0,4704,4704,0.184963825,0
105,Arkansas\Conway,11390,14767,11030,14115,88494,76375,360,652,14115,14115,0.184811784,1
2698,Texas\Matagorda,35771,32672,32534,0,234688,177001,3237,0,32672,32672,0.184586528,0
1114,Louisiana\Calcasieu,11898,15847,10721,15847,125156,85902,1177,0,15847,15847,0.184477661,1
2544,Texas\Atascosa,22644,26658,16618,19806,139080,108097,6026,6852,19806,19806,0.183224326,1
2596,Texas\Deaf Smith,131633,119924,118208,111097,524237,606733,13425,8827,111097,111097,0.183106902,1
572,Idaho\Oneida,38260,34108,35018,32045,204325,175718,3242,2063,32045,32045,0.182366064,1
284,Colorado\Sedgwick,40040,38108,39366,37691,196399,207162,674,417,37691,37691,0.181939738,1
521,Georgia\Washington,2267,7793,0,7778,39763,42768,0,15,7778,7778,0.181864946,1
2763,Texas\Tom Green,33738,31096,32651,30581,227958,168243,1087,515,30581,30581,0.181766849,1
2570,Texas\Carson,41517,49439,40741,48997,330985,269801,776,442,48997,48997,0.181604219,1
956,Kansas\Republic,43123,46533,0,0,282884,258537,0,0,46533,46533,0.179985843,0
704,Indiana\Elkhart,22028,25521,21867,25184,141649,140172,161,337,25184,25184,0.179664983,1
2246,Oregon\Umatilla,142301,147844,125833,137763,804065,769670,16468,10081,137763,137763,0.178989697,1
1279,Michigan\Mecosta,8676,14398,8671,14252,76661,79735,5,146,14252,14252,0.178742083,1
315,Florida\Columbia,2693,6070,2301,5936,30037,33356,392,134,5936,5936,0.177958988,1
2735,Texas\Robertson,21541,19679,20918,19053,117435,107891,623,626,19053,19053,0.176594897,1
2967,Washington\Snohomish,5474,5331,5076,5134,37039,29082,398,197,5134,5134,0.176535314,1
2236,Oregon\Lane,22404,19311,19000,17649,116370,100025,3404,1662,17649,17649,0.176445889,1
334,Florida\Jackson,20275,21508,19062,20649,144046,117569,1213,859,20649,20649,0.175633033,1
264,Colorado\Logan,100278,94002,95236,90050,603016,516021,5042,3952,90050,90050,0.174508402,1
968,Kansas\Sherman,103163,86954,0,86954,529976,498656,0,0,86954,86954,0.174376725,1
304,Florida\Alachua,13387,10708,12870,10231,65636,58746,517,477,10231,10231,0.174156538,1
2685,Texas\Lipscomb,19418,23341,16574,20544,126954,118399,2844,2797,20544,20544,0.173514979,1
495,Georgia\Screven,13568,17893,13327,17809,92017,103009,241,84,17809,17809,0.172887806,1
728,Indiana\LaGrange,24723,25553,24499,25303,127142,147420,224,250,25303,25303,0.171638855,1
2756,Texas\Swisher,83842,65328,77750,60229,380099,351061,6092,5099,60229,60229,0.171562777,1
1649,Montana\Wheatland,20753,21671,18159,21332,151351,124394,2594,339,21332,21332,0.171487371,1
2660,Texas\Jefferson,16896,22387,15038,19313,153620,112735,1858,3074,19313,19313,0.171313257,1
2970,Washington\Thurston,6907,5309,5459,3944,26283,23071,1448,1365,3944,3944,0.170950544,1
1221,Massachusetts\Norfolk,273,582,269,582,3292,3405,4,0,582,582,0.17092511,1
2778,Texas\Wharton,61717,71598,60125,66819,376001,391633,1592,4779,66819,66819,0.170616368,1
436,Georgia\Grady,8028,9230,7571,0,56411,54392,457,0,9230,9230,0.169694073,0
1645,Montana\Teton,111289,114794,93730,93054,600923,548912,17559,21740,93054,93054,0.169524441,1
458,Georgia\Laurens,6408,10275,6275,0,55331,60709,133,0,10275,10275,0.169250029,0
2953,Washington\King,3339,4122,2236,3306,17963,19654,1103,816,3306,3306,0.168210034,1
1626,Montana\Mineral,1342,862,533,678,4809,4032,809,184,678,678,0.168154762,1
2690,Texas\Lynn,73650,71599,72339,68148,408772,406655,1311,3451,68148,68148,0.167581857,1
1672,Nebraska\Cuming,51158,52445,50761,52377,305090,312599,397,68,52377,52377,0.167553319,1
2330,South Carolina\Allendale,6584,6548,6371,0,49090,39097,213,0,6548,6548,0.167480881,0
3116,Wyoming\Laramie,52990,59277,50834,56624,345564,338148,2156,2653,56624,56624,0.167453304,1
2321,Rhode Island,4306,3954,4266,3778,24457,22593,40,176,3778,3778,0.167219935,1
1208,Maryland\Wicomico,6955,9379,0,0,51748,56094,0,0,9379,9379,0.167201483,0
131,Arkansas\Little River,2727,10014,0,0,50912,59895,0,0,10014,10014,0.167192587,0
1119,Louisiana\Concordia,10658,28534,9788,0,157727,171253,870,0,28534,28534,0.166618979,0
2951,Washington\Island,1839,1586,1483,1229,8557,7422,356,357,1229,1229,0.16558879,1
2365,South Carolina\Orangeburg,23570,25374,22944,25242,157163,152908,626,132,25242,25242,0.165079656,1
2558,Texas\Brazos,9027,7291,7077,6911,62739,41904,1950,380,6911,6911,0.16492459,1
276,Colorado\Prowers,103205,79896,97905,78825,552476,480487,5300,1071,78825,78825,0.164052305,1
924,Kansas\Kearny,66634,70877,62434,69428,359017,423551,4200,1449,69428,69428,0.163918867,1
479,Georgia\Oconee,964,2079,778,0,13612,12685,186,0,2079,2079,0.163894363,0
1651,Montana\Yellowstone,77094,73161,65398,57542,344045,351118,11696,15619,57542,57542,0.163882228,1
1449,Mississippi\Noxubee,4874,17304,0,0,98542,105867,0,0,17304,17304,0.163450367,0
2581,Texas\Collingsworth,29688,27336,28406,26761,193475,164062,1282,575,26761,26761,0.163115164,1
1597,Montana\Big Horn,59681,46292,53931,43670,383588,268114,5750,2622,43670,43670,0.162878477,1
1887,New York\Ulster,4707,4238,4553,4238,31683,26139,154,0,4238,4238,0.162133211,1
277,Colorado\Pueblo,24606,18564,21044,14322,73537,88503,3562,4242,14322,14322,0.161825023,1
355,Florida\Pinellas,189,120,117,93,0,577,72,27,93,93,0.16117851,1
966,Kansas\Shawnee,18548,18954,0,0,125104,117689,0,0,18954,18954,0.161051585,0
977,Kansas\Wallace,43557,57963,0,56871,287916,353295,0,1092,56871,56871,0.160973124,1
2437,South Dakota\Union,39859,41433,39750,0,251355,259279,109,0,41433,41433,0.159800832,0
1144,Louisiana\Rapides,9672,21059,9281,21032,103109,132124,391,27,21032,21032,0.159183797,1
917,Kansas\Harvey,35757,47248,0,47238,273686,297248,0,10,47238,47238,0.158917806,1
2716,Texas\Ochiltree,66118,48247,0,48247,355445,304564,0,0,48247,48247,0.158413338,1
2337,South Carolina\Charleston,1304,1577,731,1384,11292,8812,573,193,1384,1384,0.157058557,1
974,Kansas\Thomas,86117,90042,85145,0,561336,576545,972,0,90042,90042,0.156175147,0
2972,Washington\Walla Walla,92438,91108,87162,88077,567192,565792,5276,3031,88077,88077,0.155670282,1
679,Illinois\Whiteside,57004,57389,57004,57369,376447,369972,0,20,57369,57369,0.155063086,1
2218,Oregon\Benton,23274,11271,21683,10536,79224,68197,1591,735,10536,10536,0.154493599,1
2954,Washington\Kitsap,926,495,562,389,3674,2527,364,106,389,389,0.153937475,1
187,California\Marin,1614,3732,1094,2217,11973,14409,520,1515,2217,2217,0.153862169,1
2560,Texas\Briscoe,31651,22824,27923,21383,166686,139594,3728,1441,21383,21383,0.153179936,1
611,Illinois\Gallatin,20616,25907,20616,25907,171632,170317,0,0,25907,25907,0.152110476,1
906,Kansas\Ford,81860,82013,80294,81962,491108,541737,1566,51,81962,81962,0.151294816,1
1686,Nebraska\Gage,59275,63795,58652,0,413217,421998,623,0,63795,63795,0.151173702,0
942,Kansas\Morton,47006,59466,0,58713,366103,389331,0,753,58713,58713,0.150804842,1
2937,Washington\Adams,124515,127046,120873,122892,825863,815010,3642,4154,122892,122892,0.15078588,1
1219,Massachusetts\Middlesex,1488,1655,1439,1604,15353,10684,49,51,1604,1604,0.150131037,1
2368,South Carolina\Saluda,4160,4432,4026,0,35031,29577,134,0,4432,4432,0.149846164,0
469,Georgia\Marion,3389,2085,0,1955,14619,13206,0,130,1955,1955,0.14803877,1
2900,Virginia\Northampton,9286,6336,9273,6336,58230,42807,13,0,6336,6336,0.148013175,1
1788,New Jersey\Monmouth,5976,3745,5812,3693,28008,25132,164,52,3693,3693,0.146944135,1
2573,Texas\Chambers,11508,15184,10037,13633,115588,92779,1471,1551,13633,13633,0.146940579,1
2702,Texas\Midland,8287,10748,6977,9145,90046,62399,1310,1603,9145,9145,0.146556836,1
2167,Oklahoma\Harmon,17805,25244,16950,24466,152249,167083,855,778,24466,24466,0.146430217,1
2582,Texas\Colorado,31545,20102,28132,19844,168984,136225,3413,258,19844,19844,0.145670765,1
1736,Nebraska\Stanton,31201,28398,30855,28395,177938,195055,346,3,28395,28395,0.145574325,1
456,Georgia\Lamar,1282,1747,0,0,13065,12021,0,0,1747,1747,0.145329008,0
374,Georgia\Bacon,5996,4395,5792,0,29928,30339,204,0,4395,4395,0.144863048,0
1139,Louisiana\Natchitoches,6145,10486,0,10186,98031,70330,0,300,10186,10186,0.144831509,1
1210,Massachusetts,23133,23433,22662,23119,187406,160789,471,314,23119,23119,0.143784712,1
3049,Wisconsin\Dunn,29335,36300,0,36300,250764,252539,0,0,36300,36300,0.143740175,1
2679,Texas\La Salle,8822,7018,0,6329,76270,44049,0,689,6329,6329,0.143680901,1
366,Florida\Union,1036,1046,1024,0,7239,7286,12,0,1046,1046,0.143562998,0
1236,Michigan\Berrien,18371,18098,18256,18081,138582,126096,115,17,18081,18081,0.14339075,1
2537,Texas,5010416,4489163,4621445,4174843,33667177,29147537,388971,314320,4174843,4174843,0.143231416,1
2546,Texas\Bailey,69655,48543,57428,44057,326039,307684,12227,4486,44057,44057,0.143189116,1
1320,Minnesota\Cass,7551,8753,7551,8753,72221,61267,0,0,8753,8753,0.14286647,1
1906,North Carolina\Burke,2077,1847,2056,0,14378,12934,21,0,1847,1847,0.142801917,0
344,Florida\Marion,9666,13214,7510,9925,59934,69750,2156,3289,9925,9925,0.142293907,1
363,Florida\Sumter,2013,3093,0,2949,29398,20734,0,144,2949,2949,0.142230153,1
256,Colorado\Jefferson,4205,2258,1572,1437,15217,10117,2633,821,1437,1437,0.142038154,1
507,Georgia\Thomas,12479,11549,12422,0,93988,81625,57,0,11549,11549,0.141488515,0
2946,Washington\Ferry,3355,2823,2957,2739,14842,19413,398,84,2739,2739,0.141091021,1
590,Illinois\Cass,21213,21260,0,0,143608,151066,0,0,21260,21260,0.140733189,0
1668,Nebraska\Cherry,44734,50879,43230,49659,414749,358507,1504,1220,49659,49659,0.138516124,1
2957,Washington\Lewis,7292,8235,5491,7387,54408,54331,1801,848,7387,7387,0.135962894,1
2790,Texas\Zapata,1980,1769,1916,0,45764,13024,64,0,1769,1769,0.135826167,0
1115,Louisiana\Caldwell,4012,4117,0,3915,28697,28828,0,202,3915,3915,0.135805467,1
1213,Massachusetts\Bristol,1872,1612,1831,1609,15236,11879,41,3,1609,1609,0.135449112,1
709,Indiana\Fulton,19550,22928,0,0,165897,169438,0,0,22928,22928,0.135317933,0
1663,Nebraska\Burt,42938,37576,42685,37479,246588,278477,253,97,37479,37479,0.134585621,1
329,Florida\Hernando,1488,2669,1266,2078,16486,15457,222,591,2078,2078,0.134437472,1
2627,Texas\Gray,23915,21638,22594,0,180564,161161,1321,0,21638,21638,0.134263252,0
3129,United States,56599305,55822231,51537104,52092384,406424909,389690414,5062201,3729847,52092384,52092384,0.133676329,1
952,Kansas\Pottawatomie,20164,21875,20164,21875,164920,164940,0,0,21875,21875,0.132623984,1
247,Colorado\El Paso,15915,7859,9237,7116,88668,53656,6678,743,7116,7116,0.132622633,1
286,Colorado\Teller,1405,444,1182,0,8846,3366,223,0,444,444,0.131907308,0
1639,Montana\Rosebud,34623,35894,30907,31354,238852,238933,3716,4540,31354,31354,0.131225071,1
1295,Michigan\Ottawa,15207,18090,15131,18040,130023,138148,76,50,18040,18040,0.13058459,1
262,Colorado\Las Animas,35066,11313,16954,9161,109509,71061,18112,2152,9161,9161,0.128917409,1
1153,Louisiana\St. Landry,33557,29779,31778,28824,220294,223939,1779,955,28824,28824,0.128713623,1
2241,Oregon\Morrow,89897,65637,78252,62437,484982,486433,11645,3200,62437,62437,0.128356834,1
2734,Texas\Roberts,8452,6297,0,0,61441,49269,0,0,6297,6297,0.127808561,0
392,Georgia\Candler,3721,3017,3568,2989,36838,23398,153,28,2989,2989,0.127745961,1
1956,North Carolina\Montgomery,989,1240,983,0,11649,9733,6,0,1240,1240,0.127401623,0
671,Illinois\Tazewell,31405,38492,31342,38492,306393,304039,63,0,38492,38492,0.126602179,1
891,Kansas\Clay,18337,29219,0,0,216556,230795,0,0,29219,29219,0.126601529,0
1729,Nebraska\Sarpy,11844,10385,0,0,86719,82246,0,0,10385,10385,0.126267539,0
1228,Michigan\Allegan,21286,28149,21148,28125,226541,223343,138,24,28125,28125,0.125927385,1
62,Alabama\Tallapoosa,0,1134,0,1060,13121,8438,10,74,1060,1060,0.125622185,1
2370,South Carolina\Sumter,9486,8863,0,8687,88781,69467,0,176,8687,8687,0.125052183,1
258,Colorado\Kit Carson,118020,110235,115836,108476,885783,872343,2184,1759,108476,108476,0.12435017,1
1799,New Mexico\Catron,3063,5432,423,379,5064,3051,2640,5053,379,379,0.124221567,1
1803,New Mexico\Curry,72924,62175,69048,58996,411511,479041,3876,3179,58996,58996,0.123154386,1
113,Arkansas\Faulkner,4261,6790,0,6707,71453,54535,0,83,6707,6707,0.122985239,1
2595,Texas\Dawson,77686,61154,76429,59094,462370,481207,1257,2060,59094,59094,0.1228037,1
2352,South Carolina\Hampton,2812,6332,0,6332,50192,51671,0,0,6332,6332,0.122544561,1
2584,Texas\Comanche,12627,18101,11704,16396,170318,133827,923,1705,16396,16396,0.122516383,1
1820,New Mexico\Roosevelt,70206,46082,60693,35344,403330,290281,9513,10738,35344,35344,0.121757883,1
1203,Maryland\Queen Anne's,12903,15805,12903,0,120336,129940,0,0,15805,15805,0.121633061,0
2774,Texas\Waller,9904,10067,9317,9655,103518,79906,587,412,9655,9655,0.120829475,1
1675,Nebraska\Dawes,17572,21390,16688,20763,202946,172727,884,627,20763,20763,0.120207032,1
61,Alabama\Talladega,3209,4771,0,4740,48612,39713,0,31,4740,4740,0.119356382,1
1265,Michigan\Kalkaska,1251,1605,0,1525,13710,12859,0,80,1525,1525,0.118593981,1
148,Arkansas\Pope,4048,6218,3812,6076,65829,51283,236,142,6076,6076,0.118479808,1
1861,New York\Nassau,174,83,142,34,268,289,32,49,34,34,0.117647059,1
2238,Oregon\Linn,32222,28687,27308,26675,257345,227547,4914,2012,26675,26675,0.117228529,1
2942,Washington\Clark,4413,3721,3631,3387,34296,28986,782,334,3387,3387,0.116849514,1
889,Kansas\Cheyenne,43730,39543,0,39083,346766,336712,0,460,39083,39083,0.116072489,1
57,Alabama\Russell,2560,3408,2452,0,24328,29426,108,0,3408,3408,0.115815945,0
2633,Texas\Hall,27910,27774,26750,21546,219015,186270,1160,6228,21546,21546,0.1156708,1
319,Florida\Escambia,2552,4628,2459,0,52296,40133,93,0,4628,4628,0.115316572,0
1289,Michigan\Oceana,6947,10427,6832,10293,83337,89357,115,134,10293,10293,0.115189633,1
726,Indiana\Knox,30206,34909,30206,0,308052,303955,0,0,34909,34909,0.114849238,0
454,Georgia\Johnson,1614,1728,0,1728,21167,15054,0,0,1728,1728,0.114786768,1
1154,Louisiana\St. Martin,8411,6673,7281,0,58553,58229,1130,0,6673,6673,0.114599255,0
2333,South Carolina\Barnwell,3871,4352,0,4300,46790,37528,0,52,4300,4300,0.114581113,1
964,Kansas\Sedgwick,37514,45424,37439,45356,405081,395977,75,68,45356,45356,0.114542006,1
1524,Missouri\Holt,22970,19034,22970,19034,199420,166501,0,0,19034,19034,0.114317632,1
242,Colorado\Denver,0,5,85,5,207,44,0,0,5,5,0.113636364,1
1472,Mississippi\Warren,3929,4927,0,0,42050,43798,0,0,4927,4927,0.112493721,0
1637,Montana\Richland,55955,62730,54672,62220,568304,556505,1283,510,62220,62220,0.111804925,1
34,Alabama\Henry,4995,8142,0,0,79687,72889,0,0,8142,8142,0.111704098,0
1823,New Mexico\San Miguel,8712,4616,4040,2502,61382,22430,4672,2114,2502,2502,0.111547035,1
1632,Montana\Pondera,74463,65774,67557,63017,617864,568180,6906,2757,63017,63017,0.110910275,1
2325,Rhode Island\Providence,807,580,782,537,5823,4869,25,43,537,537,0.110289587,1
2784,Texas\Wilson,13462,12437,8945,11387,153867,103263,4517,1050,11387,11387,0.11027183,1
2605,Texas\Ector,1109,771,744,401,6993,3645,365,370,401,401,0.110013717,1
2675,Texas\Knox,21929,21583,20968,20634,212746,189671,961,949,20634,20634,0.108788376,1
494,Georgia\Schley,1330,769,1330,0,9645,7117,0,0,769,769,0.108051145,0
1370,Minnesota\Pope,38127,28870,37870,28807,285223,267478,257,63,28807,28807,0.107698577,1
1701,Nebraska\Johnson,11281,14298,0,0,113982,132877,0,0,14298,14298,0.107603272,0
2557,Texas\Brazoria,11980,20439,11593,18919,186201,175913,387,1520,18919,18919,0.107547481,1
2210,Oklahoma\Tulsa,3901,4665,3429,4590,59478,42733,472,75,4590,4590,0.107411134,1
2779,Texas\Wheeler,14065,11189,9838,10622,151108,99647,4227,567,10622,10622,0.106596285,1
1678,Nebraska\Dixon,21583,23966,21464,23966,188725,226275,119,0,23966,23966,0.105915368,1
1109,Louisiana\Avoyelles,20215,21717,19384,21533,203144,203474,831,184,21533,21533,0.105826789,1
1407,Mississippi\Choctaw,394,953,0,0,18326,9017,0,0,953,953,0.105689254,0
2782,Texas\Willacy,18516,21139,17287,20253,196362,192106,1229,886,20253,20253,0.105426171,1
1915,North Carolina\Chowan,6156,4970,6138,0,53325,47527,18,0,4970,4970,0.104572138,0
1282,Michigan\Missaukee,4573,7477,0,0,62872,71687,0,0,7477,7477,0.10430064,0
239,Colorado\Crowley,9849,5857,7552,4721,62368,45323,2297,1136,4721,4721,0.104163449,1
384,Georgia\Brantley,351,774,351,0,10816,7458,0,0,774,774,0.103781175,0
1940,North Carolina\Hertford,6018,5553,0,5553,52519,53657,0,0,5553,5553,0.103490691,1
934,Kansas\McPherson,33428,42266,32523,42266,421770,409127,905,0,42266,42266,0.103307775,1
2626,Texas\Gonzales,5275,7817,2965,7087,99016,68954,2310,730,7087,7087,0.102778664,1
925,Kansas\Kingman,21893,33668,0,33668,331995,329320,0,0,33668,33668,0.102234908,1
3071,Wisconsin\Marquette,6474,8548,0,0,90299,84161,0,0,8548,8548,0.101567234,0
372,Georgia\Appling,9092,7498,8942,7498,61642,73838,150,0,7498,7498,0.101546629,1
26,Alabama\Elmore,2010,3066,1981,0,43406,30244,29,0,3066,3066,0.101375479,0
267,Colorado\Moffat,28472,23524,17562,12112,135148,119583,10910,11412,12112,12112,0.1012853,1
1696,Nebraska\Hitchcock,18998,21491,18430,20969,192582,207355,568,522,20969,20969,0.101126088,1
2146,Oklahoma\Caddo,33152,30256,30210,27771,328912,276118,2942,2485,27771,27771,0.100576565,1
877,Kansas,2762748,2881292,2728874,2858575,28216064,28503265,33874,22717,2858575,2858575,0.100289388,1
233,Colorado\Broomfield,959,1101,0,0,4944,11053,0,0,1101,1101,0.099610965,0
1297,Michigan\Roscommon,0,269,0,0,2265,2703,0,0,269,269,0.099519053,0
2622,Texas\Garza,17108,8112,17019,0,99820,82091,89,0,8112,8112,0.098817166,0
1230,Michigan\Antrim,1642,3353,1497,0,37812,33944,145,0,3353,3353,0.098780344,0
1789,New Jersey\Morris,855,726,820,711,9280,7215,35,15,711,711,0.098544699,1
963,Kansas\Scott,41554,36485,0,35768,326539,363433,0,717,35768,35768,0.09841704,1
955,Kansas\Reno,42332,58374,41788,58160,547832,591675,544,214,58160,58160,0.098297207,1
1669,Nebraska\Cheyenne,51318,48677,49554,48366,556005,499252,1764,311,48366,48366,0.096876928,1
532,Hawaii\Hawaii,8097,6966,6559,0,81837,72028,1538,0,6966,6966,0.09671239,0
2604,Texas\Eastland,5141,8930,5012,8806,118420,91499,129,124,8806,8806,0.096241489,1
583,Illinois\Alexander,0,4977,0,0,36711,51809,0,0,4977,4977,0.09606439,0
2956,Washington\Klickitat,21349,21748,15573,18413,191395,192258,5776,3335,18413,18413,0.095772348,1
2638,Texas\Harris,7037,5945,6097,5732,91438,59879,940,213,5732,5732,0.095726382,1
2397,South Dakota\Fall River,8065,7480,3528,6098,97105,63815,4537,1382,6098,6098,0.095557471,1
43,Alabama\Lowndes,3131,3788,3084,3780,42195,40040,47,8,3780,3780,0.094405594,1
1365,Minnesota\Otter Tail,56012,58975,55766,58824,597787,623346,246,151,58824,58824,0.094368136,1
2732,Texas\Reeves,8029,10624,7230,9225,136698,98194,799,1399,9225,9225,0.093946677,1
750,Indiana\Pulaski,19978,18454,19978,0,213257,197116,0,0,18454,18454,0.09362,0
919,Kansas\Hodgeman,29432,30702,28432,30702,334328,328079,1000,0,30702,30702,0.093581119,1
335,Florida\Jefferson,2148,2388,1852,2296,33951,24608,296,92,2296,2296,0.093302991,1
2600,Texas\Dickens,4564,13412,3806,11939,143289,128339,758,1473,11939,11939,0.093027061,1
2592,Texas\Culberson,32781,5995,0,0,47213,64492,0,0,5995,5995,0.092957266,0
882,Kansas\Barton,40488,39154,0,0,406192,421276,0,0,39154,39154,0.092941445,0
2566,Texas\Calhoun,3569,5795,3065,5625,88885,60536,504,170,5625,5625,0.092919915,1
35,Alabama\Houston,13368,9138,13260,9035,114896,97381,108,103,9035,9035,0.092779906,1
44,Alabama\Macon,2562,1850,0,0,34834,20117,0,0,1850,1850,0.091962022,0
748,Indiana\Porter,8857,10038,0,0,106059,109400,0,0,10038,10038,0.091755027,0
243,Colorado\Dolores,9377,7400,8585,6702,82075,73085,792,698,6702,6702,0.091701444,1
295,Connecticut\New Haven,1548,1288,1513,1288,13778,14087,35,0,1288,1288,0.091431817,1
2414,South Dakota\Lawrence,3775,2714,3665,0,30531,29718,110,0,2714,2714,0.091325123,0
741,Indiana\Noble,8373,13713,8373,13706,130149,150121,0,7,13706,13706,0.091299685,1
2151,Oklahoma\Cimarron,45513,39430,40017,38952,413419,426854,5496,478,38952,38952,0.091253684,1
3089,Wisconsin\Sauk,15583,19745,0,19127,209605,209776,0,618,19127,19127,0.091178209,1
1216,Massachusetts\Franklin,1743,2050,1623,0,24429,22499,120,0,2050,2050,0.091115161,0
434,Georgia\Glynn,136,28,11,0,427,308,125,0,28,28,0.090909091,0
1973,North Carolina\Rockingham,3803,3372,3782,3369,44224,37178,21,3,3369,3369,0.090618107,1
107,Arkansas\Crawford,2134,4472,2084,4392,51707,48569,50,80,4392,4392,0.090428051,1
1287,Michigan\Newaygo,10340,7538,10303,7530,89457,83384,37,8,7530,7530,0.090305095,1
42,Alabama\Limestone,7398,13128,7380,0,149962,146063,18,0,13128,13128,0.089879025,0
2249,Oregon\Wasco,27733,50643,20555,18798,180603,210020,7178,31845,18798,18798,0.089505761,1
1382,Minnesota\Stearns,41487,52041,41096,51662,527643,582796,391,379,51662,51662,0.088645083,1
55,Alabama\Pike,2414,3196,2202,3109,52990,35215,212,87,3109,3109,0.088286242,1
687,Indiana\Bartholomew,10208,13512,0,13512,148255,153445,0,0,13512,13512,0.08805761,1
2641,Texas\Haskell,35058,27500,32847,26266,290949,298475,2211,1234,26266,26266,0.08800067,1
1132,Louisiana\Lafayette,3102,3166,2699,3057,49604,34782,403,109,3057,3057,0.087890288,1
2464,Tennessee\Dyer,10563,16534,0,16534,218854,188343,0,0,16534,16534,0.087786645,1
2387,South Dakota\Clay,12470,20823,12424,0,237334,237577,46,0,20823,20823,0.087647373,0
1145,Louisiana\Red River,591,2995,591,2995,37290,34276,0,0,2995,2995,0.087378924,1
1705,Nebraska\Kimball,33283,34353,31924,33578,346020,384828,1359,775,33578,33578,0.087254566,1
1595,Montana,2013167,1903019,1558122,1482359,18241710,17022177,455045,420660,1482359,1482359,0.087083985,1
2341,South Carolina\Clarendon,2761,8533,2676,0,104509,98089,85,0,8533,8533,0.086992425,0
1786,New Jersey\Mercer,1028,1073,0,0,15358,12395,0,0,1073,1073,0.086567164,0
379,Georgia\Bartow,2982,2214,0,0,24521,25598,0,0,2214,2214,0.086491132,0
1294,Michigan\Otsego,399,1233,386,0,15725,14295,13,0,1233,1233,0.086253935,0
1812,New Mexico\Lincoln,3746,1974,0,437,9323,5070,0,1537,437,437,0.086193294,1
310,Florida\Calhoun,1455,1647,1300,1625,16553,18907,155,22,1625,1625,0.085947004,1
1415,Mississippi\Forrest,1043,845,0,0,15117,9833,0,0,845,845,0.085935116,0
2323,Rhode Island\Kent,174,181,174,165,2496,1924,0,16,165,165,0.085758836,1
2609,Texas\Erath,12101,12337,11200,10629,165049,124379,901,1708,10629,10629,0.085456548,1
1489,Missouri\Bollinger,11963,6758,11963,0,94087,79312,0,0,6758,6758,0.085207787,0
2601,Texas\Dimmit,5519,4794,2315,3765,29108,44329,3204,1029,3765,3765,0.084933114,1
820,Iowa\Harrison,31237,29074,0,29041,313508,343292,0,33,29041,29041,0.084595621,1
1947,North Carolina\Lee,1545,1255,1402,1255,18553,15012,143,0,1255,1255,0.083599787,1
2838,Virginia\Accomack,6508,5370,6508,5370,76576,64271,0,0,5370,5370,0.083552458,1
1931,North Carolina\Gates,2702,3774,2582,3769,49821,45189,120,5,3769,3769,0.083405253,1
1385,Minnesota\Swift,31382,27123,31382,27123,348228,326631,0,0,27123,27123,0.083038658,1
2237,Oregon\Lincoln,840,425,538,0,5717,5137,302,0,425,425,0.082733113,0
1441,Mississippi\Lowndes,503,4772,503,4728,62852,57259,0,44,4728,4728,0.082572172,1
301,Delaware\New Castle,2711,4630,0,4622,51913,56074,0,8,4622,4622,0.082426793,1
1741,Nebraska\Washington,18479,17279,18435,0,188129,209813,44,0,17279,17279,0.082354287,0
1643,Montana\Stillwater,28721,21557,18384,15418,234618,187311,10337,6139,15418,15418,0.082312304,1
1266,Michigan\Kent,9159,9986,9137,9890,131529,120547,22,96,9890,9890,0.082042689,1
721,Indiana\Jasper,22584,21052,0,21044,315634,256664,0,8,21044,21044,0.081990462,1
727,Indiana\Kosciusko,28007,18043,27997,17997,218735,219587,10,46,17997,17997,0.081958404,1
294,Connecticut\Middlesex,682,633,0,0,7406,7728,0,0,633,633,0.081909938,0
488,Georgia\Putnam,517,789,0,0,12406,9640,0,0,789,789,0.081846473,0
1314,Minnesota\Benton,14567,11486,0,11364,136884,139942,0,122,11364,11364,0.081205071,1
1253,Michigan\Grand Traverse,1911,2957,0,2953,41123,36373,0,4,2953,2953,0.081186594,1
1677,Nebraska\Deuel,17853,17382,17536,17382,231828,216103,317,0,17382,17382,0.080433867,1
2221,Oregon\Columbia,2535,1885,1680,1451,21385,18048,855,434,1451,1451,0.08039672,1
632,Illinois\Lawrence,15694,13584,15694,0,179068,169332,0,0,13584,13584,0.080221104,0
313,Florida\Clay,913,579,812,418,5706,5229,101,161,418,418,0.079938803,1
2643,Texas\Hemphill,5309,3183,0,0,75609,39835,0,0,3183,3183,0.079904607,0
312,Florida\Citrus,1375,669,1293,579,9684,7259,82,90,579,579,0.079763053,1
1200,Maryland\Kent,7899,8343,0,0,101394,104639,0,0,8343,8343,0.079731267,0
2358,South Carolina\Lee,4322,7414,4216,0,92786,93164,106,0,7414,7414,0.079580095,0
1959,North Carolina\New Hanover,105,96,0,0,3174,1208,0,0,96,96,0.079470199,0
957,Kansas\Rice,24656,28597,24656,28597,338841,360927,0,0,28597,28597,0.079232088,1
1656,Nebraska\Banner,16056,15173,15287,0,169408,191550,769,0,15173,15173,0.079211694,0
1358,Minnesota\Morrison,18468,20273,18140,20175,250674,256103,328,98,20175,20175,0.078776898,1
2327,South Carolina,132439,159239,123413,154682,2151219,1967288,9026,4557,154682,154682,0.078627024,1
2554,Texas\Borden,2150,4958,0,0,93814,63061,0,0,4958,4958,0.078622286,0
1985,North Carolina\Vance,1492,1552,1367,1530,20134,19470,125,22,1530,1530,0.078582435,1
529,Georgia\Wilkinson,16,463,16,375,9511,4795,0,88,375,375,0.078206465,1
1628,Montana\Musselshell,8971,11429,0,9703,148889,124200,0,1726,9703,9703,0.078123994,1
2164,Oklahoma\Grady,8465,14337,8112,14252,208212,182713,353,85,14252,14252,0.078002113,1
1311,Minnesota\Anoka,2452,2568,2364,0,30107,32950,88,0,2568,2568,0.077936267,0
2781,Texas\Wilbarger,15507,15702,14387,15260,237323,196566,1120,442,15260,15260,0.077632958,1
617,Illinois\Henderson,16567,10930,16567,10930,143657,141710,0,0,10930,10930,0.077129349,1
1206,Maryland\Talbot,3509,7572,0,7572,87107,98180,0,0,7572,7572,0.07712365,1
1480,Missouri,1199981,1180886,1190101,1174543,16405595,15259319,9880,6343,1174543,1174543,0.076972177,1
2350,South Carolina\Greenville,1760,1612,1663,1586,26664,20626,97,26,1586,1586,0.076893242,1
1225,Michigan,500428,592243,496295,589020,7803643,7669071,4133,3223,589020,589020,0.076804609,1
70,Alaska\Anchorage,1724,1316,1711,0,17048,17148,13,0,1316,1316,0.076743644,0
2490,Tennessee\Lauderdale,4931,13165,4931,0,162700,172488,0,0,13165,13165,0.07632415,0
1635,Montana\Prairie,14500,9240,14064,9100,151102,119332,436,140,9100,9100,0.076257835,1
1954,North Carolina\Mecklenburg,399,452,350,452,8412,5930,49,0,452,452,0.076222597,1
749,Indiana\Posey,8806,16426,8806,16426,186790,215660,0,0,16426,16426,0.076166188,1
1903,North Carolina\Bladen,11109,4609,8561,4022,70602,52879,2548,587,4022,4022,0.07606044,1
2,Alabama\Baldwin,10159,7678,9999,7668,103036,100901,160,10,7668,7668,0.075995283,1
444,Georgia\Hart,1542,1643,1528,1643,28844,21653,14,0,1643,1643,0.075878631,1
1976,North Carolina\Sampson,29174,16295,25074,13534,210704,179337,4100,2761,13534,13534,0.075466858,1
2657,Texas\Jackson,8852,13077,8352,11408,198778,151812,500,1669,11408,11408,0.075145575,1
1971,North Carolina\Richmond,738,1458,520,1458,18480,19435,218,0,1458,1458,0.075019295,1
1186,Maryland,92805,104910,91926,104451,1405442,1396144,879,459,104451,104451,0.074813916,1
2556,Texas\Bowie,3393,5909,0,5803,96206,77845,0,106,5803,5803,0.074545571,1
2673,Texas\Kinney,2622,1234,2019,0,11632,16630,603,0,1234,1234,0.074203247,0
3128,Wyoming\Weston,6593,4229,0,4229,49282,57046,0,0,4229,4229,0.074133156,1
1496,Missouri\Cape Girardeau,18347,11589,0,11589,202882,157336,0,0,11589,11589,0.07365765,1
734,Indiana\Marshall,8606,13424,8531,13323,155981,181845,75,101,13323,13323,0.073265693,1
645,Illinois\Massac,8076,6092,0,6092,65005,83297,0,0,6092,6092,0.073135887,1
892,Kansas\Cloud,17932,15234,17932,15234,253789,208841,0,0,15234,15234,0.072945447,1
633,Illinois\Lee,21662,25398,0,25398,377611,348914,0,0,25398,25398,0.072791576,1
1957,North Carolina\Moore,2391,1592,2010,1387,26461,19189,381,205,1387,1387,0.072280994,1
1933,North Carolina\Granville,2653,2039,2602,2013,39775,27873,51,26,2013,2013,0.072220428,1
2145,Oklahoma\Bryan,9492,8066,7663,8066,167272,111828,1829,0,8066,8066,0.072128626,1
368,Florida\Wakulla,282,162,243,144,2014,1998,39,18,144,144,0.072072072,1
2382,South Dakota\Buffalo,1530,6263,1530,6263,73824,86974,0,0,6263,6263,0.072010026,1
2479,Tennessee\Haywood,5193,14184,5193,0,196282,197034,0,0,14184,14184,0.071987576,0
2322,Rhode Island\Bristol,119,78,119,78,1072,1086,0,0,78,78,0.071823204,1
49,Alabama\Mobile,3541,2754,3359,2627,44155,36600,182,127,2627,2627,0.071775956,1
2520,Tennessee\Shelby,1743,4329,1714,0,68704,60391,29,0,4329,4329,0.071682867,0
387,Georgia\Bulloch,7762,7791,7244,0,118760,108902,518,0,7791,7791,0.071541386,0
1808,New Mexico\Guadalupe,2330,3841,1252,1258,13175,17700,1078,2583,1258,1258,0.071073446,1
835,Iowa\Louisa,9449,9907,9449,9907,153487,139524,0,0,9907,9907,0.071005705,1
1110,Louisiana\Beauregard,1578,3093,1555,3017,44257,42641,23,76,3017,3017,0.0707535,1
1209,Maryland\Worcester,5234,5047,5208,5047,75405,71339,26,0,5047,5047,0.070746716,1
2697,Texas\Mason,4207,2975,2847,2044,57098,28907,1360,931,2044,2044,0.070709517,1
391,Georgia\Camden,199,72,0,0,3335,1028,0,0,72,72,0.070038911,0
230,Colorado\Baca,55679,62564,0,60638,718687,872603,0,1926,60638,60638,0.069490937,1
1217,Massachusetts\Hampden,1154,864,1135,768,12984,11066,19,96,768,768,0.069401771,1
2552,Texas\Bexar,14091,8271,9999,6146,124952,89092,4092,2125,6146,6146,0.06898487,1
1630,Montana\Petroleum,15763,11177,0,10900,100909,158270,0,277,10900,10900,0.068869653,1
2701,Texas\Menard,2101,1534,1792,1415,22731,20653,309,119,1415,1415,0.068513049,1
1891,New York\Westchester,151,146,0,99,2512,1450,0,47,99,99,0.068275862,1
1911,North Carolina\Caswell,1472,1682,0,0,37941,24763,0,0,1682,1682,0.067923919,0
2550,Texas\Bee,5738,5131,5262,4780,104923,70387,476,351,4780,4780,0.067910268,1
2606,Texas\Edwards,923,1098,630,880,24872,13014,293,218,880,880,0.067619487,1
460,Georgia\Liberty,46,40,13,40,1212,592,33,0,40,40,0.067567568,1
1598,Montana\Blaine,61782,50472,51033,42086,673822,626786,10749,8386,42086,42086,0.067145724,1
2856,Virginia\Charles City,739,1435,0,1435,18353,21393,0,0,1435,1435,0.067078016,1
2390,South Dakota\Custer,3612,3140,3145,0,87234,46911,467,0,3140,3140,0.06693526,0
2498,Tennessee\Madison,1529,7891,0,7891,134447,117891,0,0,7891,7891,0.066934711,1
3061,Wisconsin\Juneau,8785,7362,0,7267,111635,108817,0,95,7267,7267,0.066781845,1
1986,North Carolina\Wake,3764,3206,3630,2964,45922,44387,134,242,2964,2964,0.066776308,1
1977,North Carolina\Scotland,974,2211,0,2211,33834,33386,0,0,2211,2211,0.066225364,1
307,Florida\Bradford,156,696,91,604,8537,9165,65,92,604,604,0.065902891,1
1179,Maine\Penobscot,1752,2340,1748,0,47091,35578,4,0,2340,2340,0.065770982,0
2276,Pennsylvania\Delaware,36,80,36,80,1646,1218,0,0,80,80,0.065681445,1
729,Indiana\Lake,9684,8108,9684,8108,121424,124208,0,0,8108,8108,0.065277599,1
976,Kansas\Wabaunsee,7069,7019,7069,7019,127540,107629,0,0,7019,7019,0.065214766,1
1920,North Carolina\Cumberland,3375,3357,3191,3106,44614,47742,184,251,3106,3106,0.06505802,1
136,Arkansas\Miller,1601,5512,1601,0,101233,85317,0,0,5512,5512,0.064606116,0
1270,Michigan\Leelanau,1499,2165,1496,2148,33682,33270,3,17,2148,2148,0.064562669,1
1169,Maine,20994,30887,20799,30811,529253,477343,195,76,30811,30811,0.064546877,1
1276,Michigan\Manistee,2262,1295,2262,0,24835,20081,0,0,1295,1295,0.06448882,0
41,Alabama\Lee,793,894,689,785,13903,12175,104,109,785,785,0.064476386,1
2530,Tennessee\Warren,6808,5389,0,0,91434,83668,0,0,5389,5389,0.064409332,0
1215,Massachusetts\Essex,885,615,817,591,12221,9183,68,24,591,591,0.064358053,1
2220,Oregon\Clatsop,952,688,388,342,7203,5318,564,346,342,342,0.064309891,1
1384,Minnesota\Stevens,16498,19116,0,19116,318989,297309,0,0,19116,19116,0.064296742,1
287,Colorado\Washington,37553,46992,35726,44961,854392,699683,1827,2031,44961,44961,0.0642591,1
1958,North Carolina\Nash,6493,5992,5723,5866,94692,91474,770,126,5866,5866,0.064127512,1
2343,South Carolina\Darlington,4134,7334,4084,7281,115414,113684,50,53,7281,7281,0.064045952,1
1925,North Carolina\Duplin,25281,11721,20582,9928,159329,155023,4699,1793,9928,9928,0.06404211,1
1150,Louisiana\St. Helena,135,1437,135,1087,17078,17006,0,350,1087,1087,0.063918617,1
2142,Oklahoma\Beaver,28512,24597,23889,22427,394934,351901,4623,2170,22427,22427,0.063730993,1
2969,Washington\Stevens,14950,6690,8601,5639,88344,88785,6349,1051,5639,5639,0.063512981,1
395,Georgia\Charlton,111,105,111,98,3205,1545,0,7,98,98,0.063430421,1
1929,North Carolina\Franklin,5343,3756,4797,0,49161,59501,546,0,3756,3756,0.063124989,0
291,Connecticut\Fairfield,245,314,233,0,6646,4979,12,0,314,314,0.063064872,0
908,Kansas\Geary,2979,3619,2979,3619,60488,57871,0,0,3619,3619,0.06253564,1
915,Kansas\Hamilton,24767,30926,0,30398,455222,486430,0,528,30398,30398,0.062492034,1
2648,Texas\Hood,4336,2821,3881,2708,80768,43336,455,113,2708,2708,0.062488462,1
1602,Montana\Cascade,35558,33414,28274,26715,506643,427698,7284,6699,26715,26715,0.062462298,1
2728,Texas\Randall,19791,15880,18204,15632,270137,250837,1587,248,15632,15632,0.062319355,1
2367,South Carolina\Richland,1425,1951,0,1937,23472,31107,0,14,1937,1937,0.062268943,1
518,Georgia\Walton,843,923,755,886,19323,14253,88,37,886,886,0.062162352,1
2964,Washington\San Juan,393,343,311,0,9033,5522,82,0,343,343,0.062115176,0
1927,North Carolina\Edgecombe,6674,5870,6563,5611,103474,90377,111,259,5611,5611,0.06208438,1
1136,Louisiana\Livingston,428,329,417,0,8879,5304,11,0,329,329,0.062028658,0
1963,North Carolina\Pamlico,913,2438,0,2438,40538,39386,0,0,2438,2438,0.061900168,1
422,Georgia\Effingham,44,1073,44,0,14725,17363,0,0,1073,1073,0.061798076,0
2324,Rhode Island\Newport,581,494,581,400,5694,6482,0,94,400,400,0.061709349,1
2355,South Carolina\Kershaw,1438,1134,866,1029,23318,16701,572,105,1029,1029,0.061613077,1
2655,Texas\Irion,1256,713,1090,660,7500,10740,166,53,660,660,0.061452514,1
2959,Washington\Mason,1196,777,438,290,6075,4754,758,487,290,290,0.061001262,1
2342,South Carolina\Colleton,2630,2824,2356,2790,37471,45862,274,34,2790,2790,0.060834678,1
1171,Maine\Aroostook,10836,11404,10813,11404,200205,187479,23,0,11404,11404,0.060828146,1
290,Connecticut,9901,9272,9738,9149,163686,151144,163,123,9149,9149,0.060531678,1
2879,Virginia\Hanover,3188,3338,3119,3331,56034,55173,69,7,3331,3331,0.060373734,1
2751,Texas\Starr,6463,8583,5006,7907,173150,131272,1457,676,7907,7907,0.060233713,1
1185,Maine\York,1309,1272,1309,1260,21989,20995,0,12,1260,1260,0.060014289,1
1770,New Hampshire\Hillsborough,821,681,0,664,13074,11072,0,17,664,664,0.059971098,1
1391,Minnesota\Washington,3381,3504,3345,0,57503,58485,36,0,3504,3504,0.059912798,0
1238,Michigan\Calhoun,9274,10662,9227,10506,175143,175599,47,156,10506,10506,0.059829498,1
1867,New York\Orange,4560,2734,4363,0,46268,45794,197,0,2734,2734,0.059702144,0
1343,Minnesota\Kandiyohi,17509,20986,17396,0,348963,354055,113,0,20986,20986,0.059273277,0
2345,South Carolina\Dorchester,1845,2062,1787,2045,37410,34532,58,17,2045,2045,0.059220433,1
305,Florida\Baker,699,303,0,260,4695,4402,0,43,260,260,0.059064062,1
1926,North Carolina\Durham,284,382,284,0,8433,6504,0,0,382,382,0.058733087,0
2439,South Dakota\Yankton,10707,15530,10707,15530,249268,265001,0,0,15530,15530,0.058603552,1
2178,Oklahoma\Le Flore,9398,6079,9160,6079,154956,103734,238,0,6079,6079,0.058601808,1
2189,Oklahoma\Muskogee,8154,7304,7468,7027,144973,120201,686,277,7027,7027,0.058460412,1
2366,South Carolina\Pickens,779,787,710,756,17860,12985,69,31,756,756,0.058221024,1
1988,North Carolina\Washington,3177,4400,0,4400,82707,75854,0,0,4400,4400,0.05800617,1
3035,Wisconsin\Barron,10333,11737,0,11730,207201,202890,0,7,11730,11730,0.057814579,1
1613,Montana\Glacier,30704,34064,28475,30371,552364,525608,2229,3693,30371,30371,0.057782606,1
2434,South Dakota\Todd,8519,7220,8519,7220,139607,125212,0,0,7220,7220,0.057662205,1
1509,Missouri\Dade,8621,6519,0,0,127080,113406,0,0,6519,6519,0.057483731,0
470,Georgia\Meriwether,765,919,0,919,22228,16011,0,0,919,919,0.057398039,1
667,Illinois\Scott,5547,7034,5547,7034,108960,122771,0,0,7034,7034,0.057293661,1
1633,Montana\Powder River,10039,9861,0,9837,178104,171713,0,24,9837,9837,0.057287451,1
3079,Wisconsin\Pepin,1470,3583,1470,3577,67504,63018,0,6,3577,3577,0.05676156,1
2616,Texas\Fort Bend,8339,10309,6561,7669,152112,135854,1778,2640,7669,7669,0.056450307,1
2916,Virginia\Rockingham,4808,5645,0,0,114523,100455,0,0,5645,5645,0.056194316,0
424,Georgia\Emanuel,7626,3657,7626,3657,54865,65097,0,0,3657,3657,0.056177704,1
244,Colorado\Douglas,3453,1686,3136,1309,35067,23303,317,377,1309,1309,0.056173025,1
909,Kansas\Gove,17735,21050,0,20664,371343,368918,0,386,20664,20664,0.056012447,1
1386,Minnesota\Todd,15589,14071,15334,13839,228715,248050,255,232,13839,13839,0.055791171,1
2743,Texas\San Saba,3760,3633,3643,2967,80216,53223,117,666,2967,2967,0.055746576,1
17,Alabama\Colbert,2422,3685,0,3661,60028,65683,0,24,3661,3661,0.055737405,1
435,Georgia\Gordon,887,1828,789,1828,31063,32810,98,0,1828,1828,0.055714721,1
3,Alabama\Barbour,2785,2301,0,2301,56934,41301,0,0,2301,2301,0.055712937,1
2436,South Dakota\Turner,25617,18297,0,18219,308316,329332,0,78,18219,18219,0.055321074,1
145,Arkansas\Pike,566,979,350,824,23652,14902,216,155,824,824,0.055294591,1
678,Illinois\White,24159,15201,0,15201,265834,275108,0,0,15201,15201,0.055254664,1
1739,Nebraska\Thurston,7813,11915,7712,11915,173210,215904,101,0,11915,11915,0.055186564,1
2704,Texas\Mills,4878,3278,3747,3171,74638,57476,1131,107,3171,3171,0.055170854,1
2755,Texas\Sutton,891,1267,704,603,21603,10958,187,664,603,603,0.05502829,1
1982,North Carolina\Transylvania,997,363,997,363,7730,6616,0,0,363,363,0.054866989,1
165,Arkansas\Yell,4196,3096,0,0,67004,56495,0,0,3096,3096,0.05480131,0
1967,North Carolina\Person,1764,2772,0,2705,52116,49500,0,67,2705,2705,0.054646465,1
59,Alabama\Shelby,2172,1110,1937,1018,21070,18677,235,92,1018,1018,0.054505542,1
433,Georgia\Glascock,107,346,0,346,6575,6355,0,0,346,346,0.054445319,1
2539,Texas\Andrews,12244,4992,0,3885,62247,71517,0,1107,3885,3885,0.054322748,1
2895,Virginia\Mecklenburg,3235,2760,3136,2751,66145,50846,99,9,2751,2751,0.054104551,1
597,Illinois\Cook,247,405,0,405,6470,7501,0,0,405,405,0.053992801,1
1716,Nebraska\Nemaha,8439,11402,8439,11402,169508,211371,0,0,11402,11402,0.053943067,1
928,Kansas\Lane,14016,18734,0,18137,284111,336970,0,597,18137,18137,0.053823783,1
946,Kansas\Norton,12104,14536,0,14536,301450,270553,0,0,14536,14536,0.053726996,1
6,Alabama\Bullock,0,1399,0,0,32928,26119,0,0,1399,1399,0.053562541,0
1202,Maryland\Prince George's,726,780,0,773,17376,14435,0,7,773,773,0.053550398,1
3086,Wisconsin\Rock,15560,16216,15403,16213,298238,303657,157,3,16213,16213,0.053392479,1
1483,Missouri\Atchison,9029,12207,9029,0,264162,228641,0,0,12207,12207,0.053389375,0
1660,Nebraska\Boyd,4488,5221,4488,5221,90271,98033,0,0,5221,5221,0.053257577,1
2545,Texas\Austin,1559,4253,1388,3787,96559,71224,171,466,3787,3787,0.05317028,1
1278,Michigan\Mason,3271,2995,0,2995,55946,56689,0,0,2995,2995,0.052832119,1
2910,Virginia\Prince William,685,1006,672,0,18182,19048,13,0,1006,1006,0.052813944,0
400,Georgia\Clarke,117,110,99,110,2953,2083,18,0,110,110,0.052808449,1
1707,Nebraska\Lancaster,15553,21428,15276,21261,323610,402619,277,167,21261,21261,0.052806748,1
2680,Texas\Lavaca,3233,4299,2699,4252,113084,80760,534,47,4252,4252,0.052649827,1
637,Illinois\McHenry,8513,11161,8371,11161,198762,212556,142,0,11161,11161,0.052508515,1
2206,Oklahoma\Sequoyah,1622,3348,1519,0,73484,63770,103,0,3348,3348,0.052501176,0
2696,Texas\Martin,16910,17128,16506,14670,275982,279609,404,2458,14670,14670,0.052466122,1
1112,Louisiana\Bossier,113,1490,113,0,37807,28441,0,0,1490,1490,0.052389156,0
1765,New Hampshire\Belknap,68,300,0,300,6108,5744,0,0,300,300,0.052228412,1
3060,Wisconsin\Jefferson,7454,9467,0,0,190189,181813,0,0,9467,9467,0.052069984,0
1324,Minnesota\Clearwater,0,3951,0,3951,91245,76181,0,0,3951,3951,0.051863326,1
3059,Wisconsin\Jackson,4205,7226,0,0,127122,139347,0,0,7226,7226,0.051856158,0
589,Illinois\Carroll,10501,11320,10501,11320,228142,218830,0,0,11320,11320,0.051729653,1
894,Kansas\Comanche,4386,7491,0,0,128533,144933,0,0,7491,7491,0.051685951,0
2379,South Dakota\Brookings,15884,16871,15769,0,351302,327406,115,0,16871,16871,0.051529294,0
2854,Virginia\Caroline,2111,1959,2046,1943,36045,37820,65,16,1943,1943,0.051374934,1
1036,Kentucky\Hickman,13009,6121,13009,6121,107072,119650,0,0,6121,6121,0.051157543,1
2962,Washington\Pend Oreille,1113,903,627,782,19041,15315,486,121,782,782,0.051061051,1
23,Alabama\Dale,2602,2568,2547,2526,54167,49579,55,42,2526,2526,0.050948991,1
2850,Virginia\Brunswick,1316,1281,0,1281,26820,25156,0,0,1281,1281,0.050922245,1
922,Kansas\Jewell,14013,14983,0,14983,290760,294769,0,0,14983,14983,0.050829633,1
913,Kansas\Greeley,23383,23156,23383,23156,445156,458212,0,0,23156,23156,0.05053556,1
1013,Kentucky\Daviess,3450,9594,3450,0,208973,190211,0,0,9594,9594,0.050438723,0
2747,Texas\Shelby,600,1830,474,0,45460,36385,126,0,1830,1830,0.050295451,0
2211,Oklahoma\Wagoner,5226,3979,4870,3935,114279,78552,356,44,3935,3935,0.050094205,1
485,Georgia\Pike,771,558,686,450,14528,9004,85,108,450,450,0.049977788,1
954,Kansas\Rawlins,18716,17719,18250,0,329714,354869,466,0,17719,17719,0.049931101,0
1310,Minnesota\Aitkin,4373,3084,0,3084,64411,61792,0,0,3084,3084,0.049909373,1
2725,Texas\Potter,6961,3100,6943,2696,74387,54166,18,404,2696,2696,0.04977292,1
1283,Michigan\Monroe,6483,9752,0,9752,189529,196178,0,0,9752,9752,0.049709957,1
2575,Texas\Childress,14031,9233,13344,7058,143212,142055,687,2175,7058,7058,0.049684981,1
1486,Missouri\Barton,13837,11144,13681,11094,237269,223964,156,50,11094,11094,0.049534747,1
1905,North Carolina\Buncombe,538,878,489,852,20338,17212,49,26,852,852,0.049500349,1
3101,Wisconsin\Waupaca,8561,7004,8541,7004,159820,141514,20,0,7004,7004,0.049493336,1
235,Colorado\Cheyenne,33038,26551,0,0,512038,536615,0,0,26551,26551,0.049478677,0
1648,Montana\Valley,51910,40442,45585,38873,921504,788378,6325,1569,38873,38873,0.049307566,1
2353,South Carolina\Horry,1316,5569,1194,5316,97292,108017,122,253,5316,5316,0.049214475,1
2433,South Dakota\Sully,15373,24556,15373,24556,488937,501040,0,0,24556,24556,0.049010059,1
2753,Texas\Sterling,323,622,0,0,9524,12705,0,0,622,622,0.048957104,0
1444,Mississippi\Marshall,715,3488,0,3419,67569,70043,0,69,3419,3419,0.048812872,1
1327,Minnesota\Crow Wing,2917,2179,2913,2179,50483,44788,4,0,2179,2179,0.048651424,1
370,Florida\Washington,888,1136,0,892,22743,18381,0,244,892,892,0.048528372,1
450,Georgia\Jasper,294,390,282,0,12418,8084,12,0,390,390,0.048243444,0
1261,Michigan\Iron,383,455,0,455,10424,9454,0,0,455,455,0.048127777,1
2369,South Carolina\Spartanburg,2090,1885,1788,1815,41547,37733,302,70,1815,1815,0.048101132,1
2683,Texas\Liberty,5313,5242,5027,4792,127704,101071,286,450,4792,4792,0.047412215,1
2730,Texas\Real,535,498,231,259,26097,5514,304,239,259,259,0.046971346,1
2161,Oklahoma\Ellis,12829,8701,11657,7899,167089,168731,1172,802,7899,7899,0.04681416,1
2650,Texas\Houston,4574,5958,2354,3898,109201,83560,2220,2060,3898,3898,0.046649114,1
2022,North Dakota\McKenzie,24762,19913,24138,19830,430884,425625,624,83,19830,19830,0.046590308,1
3090,Wisconsin\Sawyer,581,1019,581,1019,22484,21896,0,0,1019,1019,0.04653818,1
3104,Wisconsin\Wood,6874,6191,6789,6161,126961,132947,85,30,6161,6161,0.046341775,1
881,Kansas\Barber,9976,8947,0,8923,197682,193056,0,24,8923,8923,0.04621975,1
2929,Virginia\Westmoreland,1674,1641,1674,1641,44742,35961,0,0,1641,1641,0.045632769,1
2193,Oklahoma\Oklahoma,2935,2311,2684,2183,57515,47873,251,128,2183,2183,0.045599816,1
910,Kansas\Graham,10415,13274,10415,13274,308210,291969,0,0,13274,13274,0.045463731,1
1135,Louisiana\Lincoln,965,425,0,0,12920,9390,0,0,425,425,0.045260916,0
1913,North Carolina\Chatham,870,1206,325,1199,32774,26693,545,7,1199,1199,0.044918143,1
475,Georgia\Morgan,1817,1401,1750,1344,30996,30038,67,57,1344,1344,0.044743325,1
2185,Oklahoma\Major,8169,10119,7208,9690,237379,216957,961,429,9690,9690,0.044663228,1
598,Illinois\Crawford,6793,8312,6793,0,176560,186745,0,0,8312,8312,0.044509893,0
627,Illinois\Kankakee,15950,14573,15875,0,376178,327931,75,0,14573,14573,0.044439227,0
2525,Tennessee\Tipton,2581,5654,2581,0,144998,127288,0,0,5654,5654,0.044418955,0
1902,North Carolina\Bertie,8530,4237,8091,0,92745,95448,439,0,4237,4237,0.044390663,0
1614,Montana\Golden Valley,8575,7043,7216,6007,157383,135363,1359,1036,6007,6007,0.044376972,1
1850,New York\Genesee,7832,6346,7832,6346,145987,143305,0,0,6346,6346,0.044283172,1
1904,North Carolina\Brunswick,2506,1209,0,1209,27388,27440,0,0,1209,1209,0.044059767,1
1255,Michigan\Hillsdale,4187,9141,4071,0,212072,207931,116,0,9141,9141,0.043961699,0
1569,Missouri\Ray,4057,7678,4057,0,180487,174657,0,0,7678,7678,0.043960448,0
1419,Mississippi\Grenada,3197,1133,3197,1133,36530,25816,0,0,1133,1133,0.043887512,1
2744,Texas\Schleicher,640,1424,0,1424,49920,32505,0,0,1424,1424,0.043808645,1
1631,Montana\Phillips,48654,33213,43418,30651,610047,701968,5236,2562,30651,30651,0.043664384,1
426,Georgia\Fannin,0,202,0,159,4539,3651,0,43,159,159,0.043549712,1
2299,Pennsylvania\Montgomery,668,812,645,0,28563,18668,23,0,812,812,0.043496893,0
441,Georgia\Hancock,94,245,94,209,8575,4830,0,36,209,209,0.043271222,1
1965,North Carolina\Pender,5420,1741,4882,1319,35484,30499,538,422,1319,1319,0.04324732,1
394,Georgia\Catoosa,52,313,52,0,8183,7258,0,0,313,313,0.043124828,0
2629,Texas\Gregg,305,363,260,354,11557,8245,45,9,354,354,0.042935112,1
1406,Mississippi\Chickasaw,1743,2951,1455,2876,69307,67241,288,75,2876,2876,0.042771523,1
1484,Missouri\Audrain,15462,15134,15302,0,337854,353971,160,0,15134,15134,0.042754915,0
1143,Louisiana\Pointe Coupee,7272,6112,0,0,143377,143774,0,0,6112,6112,0.042511163,0
3088,Wisconsin\St. Croix,4799,8332,0,8332,222427,196082,0,0,8332,8332,0.042492427,1
2032,North Dakota\Ransom,18496,14833,0,14387,367796,339290,0,446,14387,14387,0.042403254,1
3032,Wisconsin,377291,421721,373680,419439,10116279,9910991,3611,2282,419439,419439,0.042320591,1
2580,Texas\Collin,708,6186,454,5778,150210,136635,254,408,5778,5778,0.042287847,1
1452,Mississippi\Pearl River,1287,1027,1287,973,30578,23040,0,54,973,973,0.042230903,1
63,Alabama\Tuscaloosa,1202,1118,1097,1066,38196,25298,105,52,1066,1066,0.042137718,1
2958,Washington\Lincoln,32071,34655,30503,33836,743236,808471,1568,819,33836,33836,0.041851841,1
246,Colorado\Elbert,12368,8435,11264,7550,224007,180530,1104,885,7550,7550,0.041821304,1
382,Georgia\Bibb,128,257,0,257,5149,6155,0,0,257,257,0.041754671,1
958,Kansas\Riley,5176,4142,0,0,103096,99399,0,0,4142,4142,0.041670439,0
1868,New York\Orleans,3489,4565,3381,4557,106304,109537,108,8,4557,4557,0.041602381,1
1275,Michigan\Macomb,3011,2455,0,2429,54843,58407,0,26,2429,2429,0.041587481,1
1461,Mississippi\Simpson,190,1170,190,1170,29718,28157,0,0,1170,1170,0.041552722,1
1690,Nebraska\Grant,1475,1703,0,0,45299,41004,0,0,1703,1703,0.041532533,0
407,Georgia\Columbia,79,82,22,0,4676,1975,57,0,82,82,0.041518987,0
1468,Mississippi\Tishomingo,0,688,0,688,20087,16616,0,0,688,688,0.041405874,1
369,Florida\Walton,718,1316,592,1271,46685,30700,126,45,1271,1271,0.041400651,1
1606,Montana\Dawson,19722,17151,18146,16463,446355,399394,1576,688,16463,16463,0.041219948,1
3058,Wisconsin\Iron,234,200,234,200,4125,4859,0,0,200,200,0.041160733,1
897,Kansas\Decatur,8602,11067,0,0,283707,269092,0,0,11067,11067,0.041127198,0
2171,Oklahoma\Jackson,55120,14062,53163,12146,300961,295644,1957,1916,12146,12146,0.041083195,1
960,Kansas\Rush,11368,13179,0,13179,287119,321902,0,0,13179,13179,0.040941032,1
1938,North Carolina\Haywood,513,415,494,415,14701,10137,19,0,415,415,0.040939134,1
2637,Texas\Hardin,971,1671,811,929,22100,22708,160,742,929,929,0.040910692,1
1771,New Hampshire\Merrimack,683,561,674,0,16344,13743,9,0,561,561,0.040820781,0
188,California\Mariposa,0,1806,0,512,4377,12575,0,1294,512,512,0.040715706,1
1224,Massachusetts\Worcester,930,1322,868,1309,35623,32203,62,13,1309,1309,0.040648387,1
547,Idaho\Boundary,2765,2081,2592,1897,43163,46698,173,184,1897,1897,0.040622725,1
1719,Nebraska\Pawnee,4620,7305,4620,7305,139385,180059,0,0,7305,7305,0.040570035,1
428,Georgia\Floyd,1082,804,0,791,28021,19550,0,13,791,791,0.040460358,1
40,Alabama\Lawrence,4062,4702,3821,4636,116060,114650,241,66,4636,4636,0.04043611,1
545,Idaho\Bonner,2058,1176,1678,1056,28834,26147,380,120,1056,1056,0.040387042,1
1766,New Hampshire\Carroll,100,157,0,157,6793,3899,0,0,157,157,0.040266735,1
761,Indiana\Sullivan,9657,6039,9657,6031,157852,149999,0,8,6031,6031,0.040206935,1
847,Iowa\Muscatine,7275,7364,7275,7364,188458,183169,0,0,7364,7364,0.04020331,1
3094,Wisconsin\Trempealeau,5791,7934,5791,0,192304,197816,0,0,7934,7934,0.040107979,0
1218,Massachusetts\Hampshire,1011,861,0,0,23800,21494,0,0,861,861,0.040057691,0
2138,Oklahoma,534768,479750,481169,450703,13007625,11279031,53599,29047,450703,450703,0.039959372,1
45,Alabama\Madison,6490,5089,6406,5007,122790,125355,84,82,5007,5007,0.039942563,1
2203,Oklahoma\Roger Mills,4605,5330,3786,4690,186444,117468,819,640,4690,4690,0.039925767,1
1034,Kentucky\Henderson,4059,5977,4059,5977,166381,150008,0,0,5977,5977,0.039844542,1
0,Alabama,112819,113008,106925,109717,3142958,2758521,5894,3291,109717,109717,0.03977385,1
2349,South Carolina\Georgetown,710,489,613,489,17611,12387,97,0,489,489,0.039476871,1
480,Georgia\Oglethorpe,774,678,677,678,23695,17225,97,0,678,678,0.039361393,1
1888,New York\Warren,23,58,23,58,1295,1475,0,0,58,58,0.039322034,1
2456,Tennessee\Cocke,542,802,542,802,27557,20420,0,0,802,802,0.03927522,1
1176,Maine\Knox,237,294,237,294,12050,7510,0,0,294,294,0.039147803,1
1156,Louisiana\St. Tammany,576,371,200,308,10403,7907,376,63,308,308,0.038952827,1
465,Georgia\McDuffie,506,318,506,318,9588,8179,0,0,318,318,0.038880059,1
1851,New York\Greene,735,727,699,727,22234,18716,36,0,727,727,0.03884377,1
2143,Oklahoma\Beckham,6895,6176,6315,0,187699,159771,580,0,6176,6176,0.038655325,0
2362,South Carolina\Marlboro,1550,2745,0,0,76115,71129,0,0,2745,2745,0.038591854,0
2548,Texas\Bastrop,2469,2930,1926,2325,76114,60293,543,605,2325,2325,0.03856169,1
2898,Virginia\Nelson,775,862,713,0,22898,22429,62,0,862,862,0.038432387,0
1773,New Hampshire\Strafford,168,295,0,295,8980,7692,0,0,295,295,0.038351534,1
1170,Maine\Androscoggin,515,844,515,0,23133,22041,0,0,844,844,0.038292273,0
1453,Mississippi\Perry,482,462,482,462,12026,12080,0,0,462,462,0.038245033,1
16,Alabama\Coffee,4191,3267,3959,3267,80709,85455,232,0,3267,3267,0.038230648,1
1478,Mississippi\Yalobusha,0,1276,0,1276,36152,33398,0,0,1276,1276,0.038205881,1
1898,North Carolina\Anson,474,1082,0,0,27777,28323,0,0,1082,1082,0.038202168,0
1308,Michigan\Wexford,997,906,877,0,24737,23744,120,0,906,906,0.038157008,0
3056,Wisconsin\Green Lake,3392,4570,3388,0,108478,119913,4,0,4570,4570,0.038110964,0
2562,Texas\Brown,3738,3490,3084,3212,95342,84641,654,278,3212,3212,0.037948512,1
1618,Montana\Judith Basin,16615,14008,16354,13005,285022,343216,261,1003,13005,13005,0.03789159,1
2147,Oklahoma\Canadian,3954,10007,3529,9595,278838,253784,425,412,9595,9595,0.037807742,1
612,Illinois\Greene,3785,8824,0,8824,214838,233393,0,0,8824,8824,0.037807475,1
8,Alabama\Calhoun,1729,922,0,805,25955,21357,0,117,805,805,0.03769256,1
1172,Maine\Cumberland,307,676,301,0,18109,17981,6,0,676,676,0.037595239,0
1916,North Carolina\Clay,19,162,19,162,3263,4321,0,0,162,162,0.037491321,1
2458,Tennessee\Crockett,3300,4196,3300,4196,133999,112118,0,0,4196,4196,0.037424856,1
647,Illinois\Mercer,9231,7934,9231,7934,265243,212331,0,0,7934,7934,0.037366188,1
1796,New Jersey\Warren,2426,1726,0,1726,51464,46446,0,0,1726,1726,0.037161435,1
2472,Tennessee\Grundy,676,528,676,528,22137,14245,0,0,528,528,0.037065637,1
60,Alabama\Sumter,472,1479,0,1232,35747,33260,0,247,1232,1232,0.037041491,1
1,Alabama\Autauga,1157,1555,1107,1525,42349,41293,50,30,1525,1525,0.036931199,1
2906,Virginia\Pittsylvania,4187,3716,3619,3692,103576,100408,568,24,3692,3692,0.036769978,1
2493,Tennessee\Lincoln,3128,3966,3113,0,117883,108231,15,0,3966,3966,0.036643845,0
2209,Oklahoma\Tillman,12974,10612,11635,0,301028,289950,1339,0,10612,10612,0.036599414,0
2133,Ohio\Washington,152,1812,152,0,50329,49522,0,0,1812,1812,0.036589798,0
2775,Texas\Ward,1575,215,1220,215,22899,5882,355,0,215,215,0.036552193,1
2887,Virginia\King William,2690,1125,0,1045,25605,28599,0,80,1045,1045,0.036539739,1
2460,Tennessee\Davidson,464,412,464,0,17410,11282,0,0,412,412,0.036518348,0
1490,Missouri\Boone,3596,5283,0,5261,152527,144365,0,22,5261,5261,0.036442351,1
2406,South Dakota\Hughes,9175,9817,0,9817,235077,269476,0,0,9817,9817,0.03642996,1
2924,Virginia\Surry,1028,1237,0,1237,29344,33961,0,0,1237,1237,0.036424134,1
1254,Michigan\Gratiot,6574,9510,6467,9441,254394,259530,107,69,9441,9441,0.036377297,1
1181,Maine\Sagadahoc,93,188,0,188,6784,5169,0,0,188,188,0.036370671,1
2770,Texas\Val Verde,2254,448,414,295,24755,8142,1840,153,295,295,0.036231884,1
1234,Michigan\Bay,4110,6319,4110,0,166747,174498,0,0,6319,6319,0.036212449,0
2718,Texas\Orange,553,388,355,243,15159,6718,198,145,243,243,0.03617148,1
2465,Tennessee\Fayette,2244,5336,2222,5331,154633,147414,22,5,5331,5331,0.036163458,1
740,Indiana\Newton,5735,6258,5735,6258,176285,174277,0,0,6258,6258,0.035908353,1
1233,Michigan\Barry,3092,4278,3069,4261,119985,119383,23,17,4261,4261,0.035691849,1
2904,Virginia\Page,295,1004,0,1004,27702,28179,0,0,1004,1004,0.035629369,1
2028,North Dakota\Oliver,5759,5881,5759,5881,176060,165135,0,0,5881,5881,0.035613286,1
2717,Texas\Oldham,2341,3371,0,3371,105308,94823,0,0,3371,3371,0.035550447,1
2594,Texas\Dallas,902,1416,853,1277,43547,35936,49,139,1277,1277,0.035535396,1
2866,Virginia\Fairfax,40,50,32,0,2872,1411,8,0,50,50,0.035435861,0
1908,North Carolina\Caldwell,1457,418,1315,418,11374,11806,142,0,418,418,0.035405726,1
1948,North Carolina\Lenoir,3643,3679,3440,3331,108702,94240,203,348,3331,3331,0.035345925,1
1935,North Carolina\Guilford,2412,1469,1940,0,45979,41693,472,0,1469,1469,0.035233732,0
1950,North Carolina\McDowell,149,213,0,213,6896,6061,0,0,213,213,0.035142716,1
512,Georgia\Troup,0,184,0,0,7606,5236,0,0,184,184,0.035141329,0
438,Georgia\Gwinnett,257,78,0,73,3266,2080,0,5,73,73,0.035096154,1
2017,North Dakota\Kidder,18335,15040,0,15040,420180,429836,0,0,15040,15040,0.034990089,1
2896,Virginia\Middlesex,480,478,480,478,13716,13708,0,0,478,478,0.034870149,1
2925,Virginia\Sussex,1644,1372,1644,1372,38344,39374,0,0,1372,1372,0.034845329,1
2878,Virginia\Halifax,1549,2152,1469,2140,70640,61485,80,12,2140,2140,0.034805237,1
2886,Virginia\King George,672,351,672,351,15410,10086,0,0,351,351,0.034800714,1
1772,New Hampshire\Rockingham,361,311,324,0,13587,8955,37,0,311,311,0.034729202,0
1894,North Carolina,232075,174526,208213,164414,4895204,4745014,23862,10112,164414,164414,0.034649845,1
890,Kansas\Clark,5195,6630,0,0,165197,191386,0,0,6630,6630,0.034642032,0
684,Indiana,397113,437445,395708,436004,12716037,12590633,1405,1441,436004,436004,0.034629236,1
2636,Texas\Hardeman,11489,4525,4617,0,162399,130946,6872,0,4525,4525,0.034556229,0
2676,Texas\Lamar,4022,6964,3971,6074,218599,175846,51,890,6074,6074,0.034541588,1
360,Florida\Santa Rosa,2562,2443,2524,2403,33335,69610,38,40,2403,2403,0.034520902,1
2845,Virginia\Augusta,3813,3271,0,3088,107811,89558,0,183,3088,3088,0.034480448,1
2921,Virginia\Southampton,3507,3246,3479,0,91291,94267,28,0,3246,3246,0.034434107,0
2377,South Dakota\Bennett,6736,6603,0,6143,257213,178644,0,460,6143,6143,0.034386825,1
2385,South Dakota\Charles Mix,9821,15286,0,0,403374,448940,0,0,15286,15286,0.034049093,0
2569,Texas\Camp,2118,694,2048,0,23362,20395,70,0,694,694,0.034027948,0
2006,North Dakota\Dickey,16409,16320,0,0,535368,481131,0,0,16320,16320,0.033920076,0
932,Kansas\Logan,12657,11142,12657,11142,340937,329378,0,0,11142,11142,0.033827396,1
2481,Tennessee\Henry,1725,4437,1685,4437,126517,131596,40,0,4437,4437,0.03371683,1
813,Iowa\Fremont,8667,8544,8667,8544,214889,253930,0,0,8544,8544,0.033647068,1
662,Illinois\Rock Island,3199,4038,0,4015,148749,119622,0,23,4015,4015,0.03356406,1
443,Georgia\Harris,136,231,101,0,11940,6899,35,0,231,231,0.033483113,0
1961,North Carolina\Onslow,5216,1459,4886,1285,38122,38384,330,174,1285,1285,0.033477491,1
2772,Texas\Victoria,2844,3315,2304,2675,134085,80151,540,640,2675,2675,0.033374506,1
1288,Michigan\Oakland,647,659,620,626,19977,18759,27,33,626,626,0.033370649,1
1576,Missouri\St. Louis,1388,513,1350,513,20241,15377,38,0,513,513,0.033361514,1
2513,Tennessee\Rhea,444,810,0,810,26491,24437,0,0,810,810,0.033146458,1
1021,Kentucky\Fulton,0,2460,0,2460,81507,74334,0,0,2460,2460,0.033093874,1
3073,Wisconsin\Milwaukee,63,114,63,114,4647,3457,0,0,114,114,0.032976569,1
1972,North Carolina\Robeson,4748,6540,4690,6540,209329,198645,58,0,6540,6540,0.032923054,1
2457,Tennessee\Coffee,0,2599,0,0,83786,78978,0,0,2599,2599,0.032907898,0
1312,Minnesota\Becker,8606,10386,0,10186,262950,309942,0,200,10186,10186,0.032864213,1
2835,Vermont\Windham,258,457,258,0,14996,13966,0,0,457,457,0.032722326,0
2945,Washington\Douglas,19409,18311,18496,17845,539531,545449,913,466,17845,17845,0.032716166,1
1962,North Carolina\Orange,763,789,654,714,26021,21834,109,75,714,714,0.032701292,1
1356,Minnesota\Meeker,9104,8481,9104,8481,273926,259935,0,0,8481,8481,0.032627388,1
3070,Wisconsin\Marinette,2086,2763,0,0,86555,84717,0,0,2763,2763,0.032614469,0
978,Kansas\Washington,9050,9721,8991,9721,326005,298156,59,0,9721,9721,0.032603738,1
2402,South Dakota\Hamlin,8721,7933,8573,7878,244785,241718,148,55,7878,7878,0.032591698,1
1476,Mississippi\Wilkinson,303,490,8,0,17594,15036,295,0,490,490,0.032588454,0
1494,Missouri\Callaway,4025,5426,3898,5237,166339,160866,127,189,5237,5237,0.032555046,1
2477,Tennessee\Hardin,997,1931,997,0,63483,59891,0,0,1931,1931,0.032241906,0
1466,Mississippi\Tate,2183,2236,0,2236,74958,69613,0,0,2236,2236,0.032120437,1
951,Kansas\Phillips,7598,7454,7598,7454,240106,232168,0,0,7454,7454,0.032106061,1
2659,Texas\Jeff Davis,273,115,0,0,44033,3584,0,0,115,115,0.032087054,0
2543,Texas\Armstrong,5940,4553,0,0,159407,142984,0,0,4553,4553,0.031842724,0
427,Georgia\Fayette,97,87,47,0,2679,2733,50,0,87,87,0.03183315,0
296,Connecticut\New London,550,751,542,726,25110,22824,8,25,726,726,0.031808623,1
3111,Wyoming\Crook,4552,7752,0,4805,166553,151291,0,2947,4805,4805,0.031759986,1
2036,North Dakota\Sargent,13281,13707,13006,0,429609,432498,275,0,13707,13707,0.031692632,0
1307,Michigan\Wayne,837,341,800,341,13090,10852,37,0,341,341,0.031422779,1
1339,Minnesota\Isanti,1278,3104,1220,0,87651,98929,58,0,3104,3104,0.031376037,0
226,Colorado\Adams,16963,17649,16346,17206,546942,550336,617,443,17206,17206,0.031264537,1
21,Alabama\Crenshaw,670,901,0,901,33501,29013,0,0,901,901,0.031055044,1
332,Florida\Holmes,2033,1100,236,1065,45991,34417,1797,35,1065,1065,0.03094401,1
698,Indiana\Daviess,3663,5833,3663,0,173812,189354,0,0,5833,5833,0.030804736,0
1032,Kentucky\Harrison,1669,1974,0,0,74695,64247,0,0,1974,1974,0.03072517,0
646,Illinois\Menard,2721,4289,2721,4289,150934,139895,0,0,4289,4289,0.030658708,1
713,Indiana\Hamilton,1946,3693,0,0,114304,120899,0,0,3693,3693,0.030546158,0
476,Georgia\Murray,435,572,0,0,15266,18755,0,0,572,572,0.030498534,0
1900,North Carolina\Avery,377,354,0,354,12630,11608,0,0,354,354,0.03049621,1
1296,Michigan\Presque Isle,1482,1384,0,1384,45746,45428,0,0,1384,1384,0.030465792,1
591,Illinois\Champaign,7102,17890,7102,17848,536124,591132,0,42,17848,17848,0.030192918,1
2839,Virginia\Albemarle,1026,1456,988,1390,46216,46609,38,66,1390,1390,0.029822566,1
2864,Virginia\Dinwiddie,1884,1161,0,0,35330,38960,0,0,1161,1161,0.029799795,0
1313,Minnesota\Beltrami,2799,2628,0,2628,101662,88216,0,0,2628,2628,0.029790514,1
2126,Ohio\Summit,299,287,299,0,9826,9645,0,0,287,287,0.02975635,0
153,Arkansas\Saline,775,359,0,359,15596,12126,0,0,359,359,0.029605806,1
2707,Texas\Montgomery,2262,1188,2042,931,33782,31559,220,257,931,931,0.029500301,1
1987,North Carolina\Warren,1423,771,1257,764,27909,26003,166,7,764,764,0.029381225,1
2824,Vermont\Bennington,163,328,0,328,13175,11165,0,0,328,328,0.029377519,1
31,Alabama\Geneva,2953,2735,0,0,89968,93119,0,0,2735,2735,0.02937102,0
1936,North Carolina\Halifax,1991,3523,1991,0,123867,120364,0,0,3523,3523,0.029269549,0
1259,Michigan\Ionia,5089,5953,5077,5942,193376,203105,12,11,5942,5942,0.029255804,1
2787,Texas\Wood,1909,1622,1736,1532,71722,52531,173,90,1532,1532,0.029163732,1
2749,Texas\Smith,2651,2465,2323,2247,91797,77116,328,218,2247,2247,0.029137922,1
2588,Texas\Cottle,1566,2864,0,0,153143,98437,0,0,2864,2864,0.029094751,0
2271,Pennsylvania\Clinton,636,847,636,847,35648,29115,0,0,847,847,0.029091534,1
1937,North Carolina\Harnett,2510,2285,2491,2229,72086,77046,19,56,2229,2229,0.028930769,1
1079,Kentucky\Pendleton,986,917,986,0,54998,31723,0,0,917,917,0.028906472,0
1990,North Carolina\Wayne,6705,4762,5961,4239,131735,146802,744,523,4239,4239,0.028875628,1
948,Kansas\Osborne,2997,6710,2997,6710,218719,232528,0,0,6710,6710,0.02885674,1
1960,North Carolina\Northampton,2955,3154,2591,0,106222,109467,364,0,3154,3154,0.028812336,0
1951,North Carolina\Macon,130,149,0,149,6277,5175,0,0,149,149,0.028792271,1
2705,Texas\Mitchell,4113,4246,3969,4222,163760,146734,144,24,4222,4222,0.028773154,1
1263,Michigan\Jackson,3754,3908,0,3908,135138,136040,0,0,3908,3908,0.028726845,1
2158,Oklahoma\Custer,4137,8168,3756,7291,264459,254883,381,877,7291,7291,0.028605282,1
2507,Tennessee\Obion,839,6054,839,6054,211745,211753,0,0,6054,6054,0.028589914,1
2462,Tennessee\DeKalb,1077,957,0,957,38723,33510,0,0,957,957,0.028558639,1
593,Illinois\Clark,6405,6568,6405,6568,206046,230264,0,0,6568,6568,0.028523781,1
68,Alaska,3730,2451,0,2392,86238,84114,0,59,2392,2392,0.028437597,1
1001,Kentucky\Calloway,1708,3793,1692,3743,113437,131921,16,50,3743,3743,0.028373041,1
1896,North Carolina\Alexander,693,592,396,592,21490,20942,297,0,592,592,0.028268551,1
1448,Mississippi\Newton,165,639,0,0,29685,22639,0,0,639,639,0.028225628,0
3038,Wisconsin\Buffalo,3154,4582,3154,4582,159073,162746,0,0,4582,4582,0.028154302,1
2714,Texas\Nolan,5158,3307,5118,0,132632,118218,40,0,3307,3307,0.027973743,0
97,Arkansas\Calhoun,0,94,0,94,6154,3363,0,0,94,94,0.027951234,1
2170,Oklahoma\Hughes,2244,1787,1899,0,106680,64029,345,0,1787,1787,0.027909229,0
51,Alabama\Montgomery,629,1707,0,0,59779,61164,0,0,1707,1707,0.027908574,0
2687,Texas\Llano,257,788,209,594,27324,21333,48,194,594,594,0.027844185,1
2610,Texas\Falls,4361,5069,4035,4852,218574,174274,326,217,4852,4852,0.027841216,1
2669,Texas\Kent,815,1092,190,0,53591,39336,625,0,1092,1092,0.02776083,0
2152,Oklahoma\Cleveland,1139,1354,659,999,47009,36056,480,355,999,999,0.0277069,1
939,Kansas\Mitchell,7857,8399,0,8399,302845,303529,0,0,8399,8399,0.027671162,1
1895,North Carolina\Alamance,1648,878,1640,878,35935,31760,8,0,878,878,0.027644836,1
1556,Missouri\Osage,691,2277,0,2277,100245,82392,0,0,2277,2277,0.027636178,1
2340,South Carolina\Chesterfield,1083,1169,1064,1169,47189,42401,19,0,1169,1169,0.027570104,1
2441,Tennessee,81405,146442,79150,145995,6047348,5329692,2255,447,145995,145995,0.027392765,1
2168,Oklahoma\Harper,6206,5882,5546,5502,203376,201857,660,380,5502,5502,0.02725692,1
921,Kansas\Jefferson,7606,3623,0,3623,155628,133441,0,0,3623,3623,0.027150576,1
973,Kansas\Sumner,15045,16094,0,16094,571229,592945,0,0,16094,16094,0.027142484,1
2653,Texas\Hunt,2056,5448,1398,4893,171459,180315,658,555,4893,4893,0.027135846,1
2561,Texas\Brooks,1523,1070,344,705,58384,25988,1179,365,705,705,0.027127905,1
1409,Mississippi\Clarke,345,376,345,0,15437,13872,0,0,376,376,0.02710496,0
1126,Louisiana\Grant,655,459,0,459,25358,16958,0,0,459,459,0.027066871,1
2694,Texas\Madison,456,2256,414,955,39646,35322,42,1301,955,955,0.027036974,1
1325,Minnesota\Cook,0,5,0,5,208,185,0,0,5,5,0.027027027,1
464,Georgia\Lumpkin,66,80,66,80,5024,2962,0,0,80,80,0.027008778,1
2431,South Dakota\Spink,19059,19169,0,19169,686905,714684,0,0,19169,19169,0.026821644,1
1235,Michigan\Benzie,337,288,322,263,9175,9818,15,25,263,263,0.026787533,1
2469,Tennessee\Giles,1265,2358,1259,0,103973,88375,6,0,2358,2358,0.026681754,0
1306,Michigan\Washtenaw,2664,3565,2554,3555,133089,133455,110,10,3555,3555,0.026638193,1
1410,Mississippi\Clay,608,819,608,0,41441,30826,0,0,819,819,0.026568481,0
1764,New Hampshire,2482,2630,2417,2606,128938,98268,65,24,2606,2606,0.026519315,1
2968,Washington\Spokane,13458,10286,11714,9748,394876,369641,1744,538,9748,9748,0.026371533,1
1475,Mississippi\Webster,240,678,142,0,25974,25807,98,0,678,678,0.026271942,0
675,Illinois\Warren,0,8023,0,8023,260628,306004,0,0,8023,8023,0.026218612,1
2855,Virginia\Carroll,601,1086,513,1086,41737,41466,88,0,1086,1086,0.026190132,1
1178,Maine\Oxford,537,411,505,411,19660,15694,32,0,411,411,0.026188352,1
1718,Nebraska\Otoe,4150,8412,4144,8412,258398,321871,6,0,8412,8412,0.026134694,1
2670,Texas\Kerr,2258,1872,1146,1154,40238,44191,1112,718,1154,1154,0.026113915,1
2777,Texas\Webb,5082,2560,1159,658,58843,25205,3923,1902,658,658,0.026105931,1
298,Connecticut\Windham,244,524,0,0,25140,20089,0,0,524,524,0.026083927,0
2215,Oklahoma\Woodward,7565,4633,5551,3897,183430,149928,2014,736,3897,3897,0.025992476,1
1793,New Jersey\Somerset,372,526,307,0,19944,20241,65,0,526,526,0.025986858,0
587,Illinois\Bureau,10215,10601,0,10601,439887,410806,0,0,10601,10601,0.025805368,1
900,Kansas\Douglas,1809,3284,1809,3277,134741,127256,0,7,3277,3277,0.025751242,1
415,Georgia\DeKalb,13,8,13,8,574,311,0,0,8,8,0.025723473,1
975,Kansas\Trego,3971,6653,0,0,246439,258660,0,0,6653,6653,0.025721024,0
1446,Mississippi\Montgomery,564,688,0,0,25806,26770,0,0,688,688,0.025700411,0
409,Georgia\Coweta,464,357,364,293,18648,11401,100,64,293,293,0.0256995,1
429,Georgia\Forsyth,208,84,208,84,5728,3280,0,0,84,84,0.025609756,1
1945,North Carolina\Johnston,5816,3588,5532,3414,128227,133652,284,174,3414,3414,0.02554395,1
2467,Tennessee\Franklin,1691,1903,1691,0,93141,74761,0,0,1903,1903,0.025454448,0
2766,Texas\Tyler,437,580,425,416,19671,16390,12,164,416,416,0.02538133,1
493,Georgia\Rockdale,13,22,13,22,1733,867,0,0,22,22,0.025374856,1
1968,North Carolina\Pitt,4940,3599,4268,3340,131401,131703,672,259,3340,3340,0.025360091,1
58,Alabama\St. Clair,1840,344,1699,344,20976,13620,141,0,344,344,0.025256975,1
2013,North Dakota\Grand Forks,17092,18869,17092,18869,753884,749199,0,0,18869,18869,0.025185565,1
2651,Texas\Howard,8444,4189,0,4065,227974,161890,0,124,4065,4065,0.025109642,1
1842,New York\Columbia,2011,1428,1994,1428,63704,56885,17,0,1428,1428,0.025103279,1
3074,Wisconsin\Monroe,3960,4346,3895,0,167161,173238,65,0,4346,4346,0.025086875,0
2175,Oklahoma\Kingfisher,5527,9088,4187,8168,337471,327538,1340,920,8168,8168,0.024937564,1
24,Alabama\Dallas,2942,1975,2922,1911,83081,76806,20,64,1911,1911,0.024880869,1
1934,North Carolina\Greene,3589,2056,3260,1722,67402,69368,329,334,1722,1722,0.024824126,1
1863,New York\Niagara,2559,2955,2441,2939,113623,118529,118,16,2939,2939,0.02479562,1
2363,South Carolina\Newberry,1438,781,0,0,33015,31661,0,0,781,781,0.024667572,0
297,Connecticut\Tolland,635,456,631,456,16817,18545,4,0,456,456,0.024588838,1
1527,Missouri\Iron,23,487,0,425,19007,17296,0,62,425,425,0.024572155,1
2425,South Dakota\Pennington,7893,5795,0,5469,280265,222806,0,326,5469,5469,0.024546018,1
2097,Ohio\Lucas,1239,1469,0,1462,59085,59696,0,7,1462,1462,0.024490753,1
1529,Missouri\Jasper,5169,3461,4994,3126,135730,127729,175,335,3126,3126,0.02447369,1
2630,Texas\Grimes,1991,1609,1494,1383,87015,56734,497,226,1383,1383,0.024376917,1
2617,Texas\Franklin,2054,820,921,679,34731,27908,1133,141,679,679,0.024329941,1
2695,Texas\Marion,193,225,172,202,11042,8310,21,23,202,202,0.024308063,1
760,Indiana\Steuben,1545,2053,0,2053,85351,84596,0,0,2053,2053,0.024268287,1
2811,Utah\San Juan,5177,4277,3125,2736,143231,112958,2052,1541,2736,2736,0.024221392,1
2149,Oklahoma\Cherokee,972,1111,0,0,67274,45997,0,0,1111,1111,0.024153749,0
1309,Minnesota,506357,524016,499583,519952,21948603,21597136,6774,4064,519952,519952,0.024075044,1
2764,Texas\Travis,1583,1805,1260,1471,75960,61205,323,334,1471,1471,0.024033984,1
2710,Texas\Motley,3328,4239,1924,1573,105320,65766,1404,2666,1573,1573,0.023918134,1
2378,South Dakota\Bon Homme,8196,6625,0,6625,219754,277172,0,0,6625,6625,0.023902126,1
1433,Mississippi\Lafayette,185,642,0,0,35017,26860,0,0,642,642,0.023901713,0
2080,Ohio\Hamilton,677,238,0,238,12268,9994,0,0,238,238,0.023814289,1
3050,Wisconsin\Eau Claire,3669,3066,3669,3066,131611,128821,0,0,3066,3066,0.023800467,1
437,Georgia\Greene,451,195,0,195,13657,8274,0,0,195,195,0.023567803,1
1946,North Carolina\Jones,1950,1068,1735,0,51769,45326,215,0,1068,1068,0.023562635,0
1029,Kentucky\Hancock,195,549,195,549,30484,23396,0,0,549,549,0.02346555,1
1623,Montana\McCone,7238,14172,0,0,576597,604888,0,0,14172,14172,0.023429131,0
895,Kansas\Cowley,3499,6230,0,0,225771,266122,0,0,6230,6230,0.023410316,0
725,Indiana\Johnson,2133,3077,2118,0,128885,131576,15,0,3077,3077,0.023385724,0
3057,Wisconsin\Iowa,6723,4634,6723,0,201818,198162,0,0,4634,4634,0.023384907,0
399,Georgia\Cherokee,148,132,0,117,7176,5021,0,15,117,117,0.023302131,1
69,Alaska\Aleutian Islands,8,24,8,0,275,1034,0,0,24,24,0.023210832,0
2726,Texas\Presidio,2044,592,1599,569,28149,24530,445,23,569,569,0.023196086,1
1262,Michigan\Isabella,3392,3438,3392,0,154128,148858,0,0,3438,3438,0.023095836,0
2307,Pennsylvania\Schuylkill,1896,1663,1880,0,81276,72077,16,0,1663,1663,0.023072547,0
1413,Mississippi\Covington,494,595,0,565,37283,24563,0,30,565,565,0.023002076,1
2621,Texas\Galveston,614,424,498,399,21819,17562,116,25,399,399,0.022719508,1
806,Iowa\Des Moines,2515,3115,2515,0,157141,137576,0,0,3115,3115,0.022642031,0
2598,Texas\Denton,1323,3315,1018,2971,140933,131894,305,344,2971,2971,0.022525665,1
2060,Ohio\Champaign,2416,3712,2409,3712,177052,164873,7,0,3712,3712,0.022514299,1
1201,Maryland\Montgomery,1280,1024,1254,0,48563,45557,26,0,1024,1024,0.022477336,0
2771,Texas\Van Zandt,5456,2407,4533,2260,141750,100561,923,147,2260,2260,0.022473921,1
1241,Michigan\Cheboygan,245,489,0,489,25038,21791,0,0,489,489,0.022440457,1
1474,Mississippi\Wayne,241,539,241,539,26939,24020,0,0,539,539,0.022439634,1
648,Illinois\Monroe,3260,3761,3260,0,148732,167706,0,0,3761,3761,0.022426151,0
940,Kansas\Montgomery,1304,3658,1182,3658,152406,163140,122,0,3658,3658,0.022422459,1
10,Alabama\Cherokee,1189,1316,1189,1316,58326,58801,0,0,1316,1316,0.022380572,1
2837,Virginia,82187,68651,78675,66710,3274137,2990561,3512,1941,66710,66710,0.022306851,1
126,Arkansas\Johnson,944,980,869,864,40677,38735,75,116,864,864,0.022305409,1
3041,Wisconsin\Chippewa,2976,5654,2949,5572,226265,249869,27,82,5572,5572,0.022299685,1
116,Arkansas\Garland,53,312,53,188,11416,8433,0,124,188,188,0.022293371,1
1638,Montana\Roosevelt,14075,16611,13950,16198,783914,728958,125,413,16198,16198,0.022220759,1
404,Georgia\Cobb,46,32,20,0,3154,1443,26,0,32,32,0.022176022,0
745,Indiana\Parke,1631,2676,0,2676,131647,120910,0,0,2676,2676,0.022132164,1
37,Alabama\Jefferson,243,201,34,0,12245,9086,209,0,201,201,0.022121946,0
1292,Michigan\Osceola,2298,1429,2267,0,73225,64658,31,0,1429,1429,0.0221009,0
581,Illinois,474454,522479,473081,521459,23707699,23752778,1373,1020,521459,521459,0.021953601,1
1912,North Carolina\Catawba,1115,686,1067,644,36662,29336,48,42,644,644,0.02195255,1
30,Alabama\Franklin,190,795,156,768,36119,35004,34,27,768,768,0.02194035,1
20,Alabama\Covington,1246,1436,0,1436,64101,65452,0,0,1436,1436,0.021939742,1
2182,Oklahoma\McClain,1674,1730,1424,0,110639,78909,250,0,1730,1730,0.021923988,0
1588,Missouri\Vernon,7591,5354,7168,0,268025,244358,423,0,5354,5354,0.021910476,0
2742,Texas\San Patricio,14233,5607,13670,5383,258697,247713,563,224,5383,5383,0.021730793,1
3098,Wisconsin\Washburn,1108,829,0,0,45601,38201,0,0,829,829,0.021701003,0
959,Kansas\Rooks,1111,6875,1111,6875,314158,316949,0,0,6875,6875,0.021691187,1
630,Illinois\Lake,592,489,0,474,28543,21960,0,15,474,474,0.021584699,1
1417,Mississippi\George,718,486,0,416,24594,19300,0,70,416,416,0.021554404,1
15,Alabama\Cleburne,498,300,353,165,12224,7720,145,135,165,165,0.021373057,1
884,Kansas\Brown,1485,4965,1485,4965,254503,232340,0,0,4965,4965,0.021369545,1
2564,Texas\Burnet,1251,1713,1003,950,57555,44659,248,763,950,950,0.021272308,1
1272,Michigan\Livingston,1358,1413,1275,1293,69299,60990,83,120,1293,1293,0.021200197,1
763,Indiana\Tippecanoe,5531,4292,0,4254,199795,201720,0,38,4254,4254,0.021088638,1
1892,New York\Wyoming,3711,3361,0,0,157338,159507,0,0,3361,3361,0.021071176,0
1503,Missouri\Clark,1871,3179,1871,3179,181657,150888,0,0,3179,3179,0.021068607,1
2048,North Dakota\Williams,16539,15571,16327,0,799770,739086,212,0,15571,15571,0.021067914,0
969,Kansas\Smith,3736,7340,3736,7004,285271,334362,0,336,7004,7004,0.020947356,1
1121,Louisiana\East Baton Rouge,238,669,188,279,30544,13321,50,390,279,279,0.020944374,1
720,Indiana\Jackson,1955,2929,0,2929,165499,139887,0,0,2929,2929,0.020938329,1
1322,Minnesota\Chisago,1667,1594,1667,0,78370,76150,0,0,1594,1594,0.02093237,0
2335,South Carolina\Berkeley,623,407,561,0,11261,19458,62,0,407,407,0.020916847,0
1129,Louisiana\Jackson,0,72,0,0,5105,3461,0,0,72,72,0.020803236,0
2623,Texas\Gillespie,1903,1907,1516,1365,90426,66437,387,542,1365,1365,0.02054578,1
962,Kansas\Saline,2776,4838,2663,0,246730,236242,113,0,4838,4838,0.020479,0
11,Alabama\Chilton,650,484,602,0,28826,23718,48,0,484,484,0.020406442,0
104,Arkansas\Columbia,57,255,57,0,15129,12545,0,0,255,255,0.020326823,0
1918,North Carolina\Columbus,2235,2362,1871,0,106598,116272,364,0,2362,2362,0.020314435,0
1785,New Jersey\Hunterdon,1501,1183,1494,0,66553,58261,7,0,1183,1183,0.020305178,0
1970,North Carolina\Randolph,1455,1158,1264,0,63189,57069,191,0,1158,1158,0.020291226,0
1980,North Carolina\Surry,1458,1140,1335,1140,53549,56255,123,0,1140,1140,0.020264865,1
1025,Kentucky\Graves,3156,4490,0,4484,201653,221852,0,6,4484,4484,0.020211673,1
3084,Wisconsin\Racine,3526,1864,3231,1864,104990,92558,295,0,1864,1864,0.020138724,1
2468,Tennessee\Gibson,2154,5035,0,5035,250270,250220,0,0,5035,5035,0.020122292,1
1901,North Carolina\Beaufort,854,2599,0,2599,138955,129266,0,0,2599,2599,0.020105828,1
2213,Oklahoma\Washita,7300,6959,0,6846,347110,343552,0,113,6846,6846,0.019927114,1
618,Illinois\Henry,7217,8685,7217,0,446100,436769,0,0,8685,8685,0.019884653,0
2585,Texas\Concho,4486,2144,3850,2120,105973,106618,636,24,2120,2120,0.019884072,1
1247,Michigan\Dickinson,583,307,0,307,12404,15485,0,0,307,307,0.019825638,1
2183,Oklahoma\McCurtain,421,1509,0,1390,104486,70306,0,119,1390,1390,0.019770717,1
1941,North Carolina\Hoke,523,737,0,737,35384,37379,0,0,737,737,0.019716953,1
2578,Texas\Coke,0,967,0,967,45927,49049,0,0,967,967,0.019714979,1
2943,Washington\Columbia,4172,4083,3486,3635,184124,184477,686,448,3635,3635,0.019704353,1
2445,Tennessee\Bledsoe,690,838,0,838,43041,42551,0,0,838,838,0.019694014,1
1846,New York\Erie,2959,1872,2793,1838,98588,93833,166,34,1838,1838,0.019587991,1
2826,Vermont\Chittenden,386,505,375,505,31161,25889,11,0,505,505,0.019506354,1
2181,Oklahoma\Love,1838,1127,1018,949,87966,48820,820,178,949,949,0.019438755,1
2361,South Carolina\Marion,916,1133,861,865,42410,44522,55,268,865,865,0.019428597,1
3069,Wisconsin\Marathon,7072,6211,6594,0,323614,320051,478,0,6211,6211,0.019406282,0
2162,Oklahoma\Garfield,5359,8387,4807,0,443160,433030,552,0,8387,8387,0.019368173,0
1544,Missouri\Marion,2956,3049,2956,3049,166178,157511,0,0,3049,3049,0.019357378,1
736,Indiana\Miami,1999,3058,1999,3058,156275,158071,0,0,3058,3058,0.019345737,1
2374,South Dakota,373842,378678,358807,370081,19094311,19147320,15035,8597,370081,370081,0.019328084,1
861,Iowa\Sioux,9096,8543,9082,0,441832,442375,14,0,8543,8543,0.01931167,0
102,Arkansas\Cleburne,184,795,184,715,38482,37039,0,80,715,715,0.019303977,1
757,Indiana\Shelby,3326,4253,3326,0,193981,220574,0,0,4253,4253,0.019281511,0
710,Indiana\Gibson,4944,4826,4944,4826,209283,250308,0,0,4826,4826,0.019280247,1
2416,South Dakota\Lyman,9810,8742,8845,0,467693,456423,965,0,8742,8742,0.019153285,0
2724,Texas\Polk,1440,443,0,443,23720,23208,0,0,443,443,0.019088245,1
1157,Louisiana\Tangipahoa,1636,727,1334,692,55865,36280,302,35,692,692,0.01907387,1
1726,Nebraska\Richardson,2180,4686,2180,4686,209034,245822,0,0,4686,4686,0.019062574,1
2166,Oklahoma\Greer,3442,3659,2977,2715,146879,142876,465,944,2715,2715,0.019002492,1
1304,Michigan\Tuscola,5824,5400,5756,0,301433,284535,68,0,5400,5400,0.018978333,0
1609,Montana\Fergus,19839,12352,18876,11231,664740,592352,963,1121,11231,11231,0.01896001,1
1244,Michigan\Clinton,4280,4200,0,3894,233342,205697,0,306,3894,3894,0.018930757,1
1535,Missouri\Lawrence,2416,2276,0,2224,150703,118108,0,52,2224,2224,0.018830223,1
2667,Texas\Kendall,694,912,281,517,34071,27527,413,395,517,517,0.01878156,1
1094,Kentucky\Trigg,941,1523,0,1347,74014,71774,0,176,1347,1347,0.018767242,1
1923,North Carolina\Davidson,1522,766,1443,0,45269,40826,79,0,766,766,0.018762553,0
1429,Mississippi\Jefferson,0,561,0,0,35255,29915,0,0,561,561,0.018753134,0
2348,South Carolina\Florence,2465,1753,0,0,111572,94291,0,0,1753,1753,0.018591382,0
2199,Oklahoma\Pittsburg,1671,1775,1251,0,125758,95571,420,0,1775,1775,0.01857258,0
2857,Virginia\Charlotte,731,760,717,760,40739,40972,14,0,760,760,0.018549253,1
2628,Texas\Grayson,3066,3513,2776,3269,166541,176390,290,244,3269,3269,0.018532797,1
776,Indiana\Whitley,1006,2228,0,2228,118326,120288,0,0,2228,2228,0.018522213,1
2373,South Carolina\York,968,716,896,706,39334,38127,72,10,706,706,0.018517061,1
923,Kansas\Johnson,1421,1093,1391,0,69923,59216,30,0,1093,1093,0.018457849,0
2376,South Dakota\Beadle,19974,11220,19865,10620,492427,576930,109,600,10620,10620,0.018407779,1
432,Georgia\Gilmer,103,97,0,0,9589,5314,0,0,97,97,0.01825367,0
1815,New Mexico\McKinley,4524,1901,2930,804,31395,44126,1594,1097,804,804,0.01822055,1
2386,South Dakota\Clark,6591,7306,6591,7306,335735,401298,0,0,7306,7306,0.018205922,1
742,Indiana\Ohio,164,191,0,0,10208,10493,0,0,191,191,0.018202611,0
2662,Texas\Jim Wells,1757,4795,1347,3490,150931,192026,410,1305,3490,3490,0.018174622,1
659,Illinois\Putnam,455,951,455,951,53930,52344,0,0,951,951,0.018168271,1
1009,Kentucky\Clay,28,180,28,180,14966,9933,0,0,180,180,0.018121413,1
658,Illinois\Pulaski,0,1171,0,1171,83161,64727,0,0,1171,1171,0.018091368,1
2289,Pennsylvania\Lancaster,5366,6076,0,6003,326648,331973,0,73,6003,6003,0.018082796,1
1845,New York\Dutchess,1293,843,1203,823,46938,45576,90,20,823,823,0.01805775,1
1525,Missouri\Howard,12049,2755,0,2505,172316,139864,0,250,2505,2505,0.017910256,1
1323,Minnesota\Clay,5911,9918,0,9918,549592,555239,0,0,9918,9918,0.017862578,1
1246,Michigan\Delta,496,625,496,625,40381,35030,0,0,625,625,0.01784185,1
1546,Missouri\Miller,1221,1358,786,1106,77120,62031,435,252,1106,1106,0.017829795,1
1335,Minnesota\Grant,4025,4982,4025,4982,292134,279634,0,0,4982,4982,0.017816145,1
1204,Maryland\St. Mary's,1065,741,979,734,39794,41216,86,7,734,734,0.017808618,1
2344,South Carolina\Dillon,1052,1339,0,1339,84517,75247,0,0,1339,1339,0.017794729,1
2971,Washington\Wahkiakum,207,48,99,48,4660,2701,108,0,48,48,0.017771196,1
2356,South Carolina\Lancaster,258,264,214,248,17756,14023,44,16,248,248,0.017685231,1
949,Kansas\Ottawa,4526,4221,0,4221,263812,238999,0,0,4221,4221,0.017661162,1
27,Alabama\Escambia,1940,836,1845,0,58335,47671,95,0,836,836,0.017536867,0
1919,North Carolina\Craven,1186,910,1098,902,49506,51475,88,8,902,902,0.017523069,1
2262,Pennsylvania\Bucks,1421,839,1366,0,58012,47951,55,0,839,839,0.017497028,0
2254,Pennsylvania\Adams,1916,2198,1916,0,127521,125642,0,0,2198,2198,0.01749415,0
2663,Texas\Johnson,1907,2386,1559,2094,116672,119878,348,292,2094,2094,0.017467759,1
1194,Maryland\Charles,623,455,591,441,29627,25277,32,14,441,441,0.017446691,1
1330,Minnesota\Douglas,2007,3441,1805,0,184201,197806,202,0,3441,3441,0.017395832,0
396,Georgia\Chatham,149,26,67,26,1164,1497,82,0,26,26,0.017368069,1
446,Georgia\Henry,158,97,153,97,8295,5597,5,0,97,97,0.017330713,1
2531,Tennessee\Washington,925,854,916,0,62646,49377,9,0,854,854,0.017295502,0
1088,Kentucky\Scott,998,831,998,0,62549,48052,0,0,831,831,0.017293765,0
2780,Texas\Wichita,6725,2952,4101,2019,129505,117135,2624,933,2019,2019,0.017236522,1
2255,Pennsylvania\Allegheny,333,243,325,243,18397,14098,8,0,243,243,0.017236487,1
2757,Texas\Tarrant,1388,881,850,653,46134,38033,538,228,653,653,0.0171693,1
1188,Maryland\Anne Arundel,342,257,0,253,16340,14742,0,4,253,253,0.01716185,1
2576,Texas\Clay,1018,1701,831,0,116986,99185,187,0,1701,1701,0.017149771,0
1563,Missouri\Platte,2390,1719,2355,0,128023,100654,35,0,1719,1719,0.017078308,0
2357,South Carolina\Laurens,435,676,380,597,38752,34974,55,79,597,597,0.017069823,1
1431,Mississippi\Jones,354,433,354,433,32184,25451,0,0,433,433,0.017013084,1
2364,South Carolina\Oconee,309,323,217,262,21566,15401,92,61,262,262,0.017011882,1
885,Kansas\Butler,6182,5100,0,5030,314748,295902,0,70,5030,5030,0.016998871,1
1177,Maine\Lincoln,141,126,141,0,9489,7413,0,0,126,126,0.016997167,0
2099,Ohio\Mahoning,580,924,580,0,46353,54494,0,0,924,924,0.016955995,0
3097,Wisconsin\Walworth,2519,2779,0,2779,182277,163902,0,0,2779,2779,0.016955254,1
2745,Texas\Scurry,2866,3742,2795,3488,214315,206448,71,254,3488,3488,0.016895296,1
2453,Tennessee\Chester,52,474,0,474,36363,28059,0,0,474,474,0.016892976,1
1969,North Carolina\Polk,200,120,182,120,6809,7108,18,0,120,120,0.016882386,1
2329,South Carolina\Aiken,3153,1270,2768,942,62150,55847,385,328,942,942,0.016867513,1
228,Colorado\Arapahoe,1688,2460,1451,2303,151344,137162,237,157,2303,2303,0.016790365,1
2388,South Dakota\Codington,4571,4285,4571,4285,247710,255903,0,0,4285,4285,0.016744626,1
2470,Tennessee\Grainger,437,432,416,0,39805,25816,21,0,432,432,0.016733808,0
2739,Texas\Sabine,16,221,16,77,7812,4603,0,144,77,77,0.016728221,1
1992,North Carolina\Wilson,2831,1442,2617,1442,81781,86438,214,0,1442,1442,0.016682478,1
1550,Missouri\Montgomery,3402,3227,3383,3227,167245,194016,19,0,3227,3227,0.016632649,1
2186,Oklahoma\Marshall,2254,692,0,0,37085,41751,0,0,692,692,0.016574453,0
712,Indiana\Greene,1259,2202,1259,0,119099,132916,0,0,2202,2202,0.016566854,0
71,Alaska\Fairbanks,1956,1017,0,0,63621,61394,0,0,1017,1017,0.016565137,0
2615,Texas\Foard,2443,1861,1873,1620,120515,98217,570,241,1620,1620,0.01649409,1
1562,Missouri\Pike,1401,3725,1345,3725,244984,226028,56,0,3725,3725,0.016480259,1
2515,Tennessee\Robertson,2094,2320,2094,2311,160059,140686,0,9,2311,2311,0.016426652,1
73,Alaska\Kenai Peninsula,30,73,0,73,5253,4459,0,0,73,73,0.016371384,1
2450,Tennessee\Carroll,660,1986,660,1986,121978,121429,0,0,1986,1986,0.016355236,1
1974,North Carolina\Rowan,1116,1068,1022,0,63782,65864,94,0,1068,1068,0.016215231,0
348,Florida\Nassau,270,112,242,79,4249,4877,28,33,79,79,0.016198483,1
2574,Texas\Cherokee,1147,1405,796,1098,76592,67789,351,307,1098,1098,0.016197318,1
1249,Michigan\Emmet,158,289,0,0,21693,17872,0,0,289,289,0.016170546,0
1039,Kentucky\Jefferson,152,176,136,0,15430,10955,16,0,176,176,0.016065723,0
2892,Virginia\Lunenburg,770,444,670,0,31597,27663,100,0,444,444,0.01605032,0
1932,North Carolina\Graham,20,23,20,23,1902,1436,0,0,23,23,0.016016713,1
1434,Mississippi\Lamar,316,209,0,209,15152,13158,0,0,209,209,0.015883873,1
1979,North Carolina\Stokes,422,493,401,489,35195,30799,21,4,489,489,0.015877139,1
775,Indiana\White,3369,4230,0,4230,301049,267726,0,0,4230,4230,0.015799736,1
2547,Texas\Bandera,606,585,517,537,21421,34113,89,48,537,537,0.015741799,1
1395,Minnesota\Wright,2657,3660,2531,3649,207283,231832,126,11,3649,3649,0.015739846,1
1096,Kentucky\Union,2327,2634,2327,2634,166923,167932,0,0,2634,2634,0.01568492,1
2533,Tennessee\Weakley,495,3197,0,0,204739,203832,0,0,3197,3197,0.015684485,0
980,Kansas\Wilson,569,2229,569,2229,184779,142355,0,0,2229,2229,0.015658038,1
1463,Mississippi\Stone,8,118,8,0,10903,7541,0,0,118,118,0.015647792,0
2644,Texas\Henderson,1328,1399,1070,1281,86495,81924,258,118,1281,1281,0.015636444,1
3100,Wisconsin\Waukesha,1388,1277,1383,1181,69445,75648,5,96,1181,1181,0.015611781,1
3085,Wisconsin\Richland,1515,1740,0,0,118363,111825,0,0,1740,1740,0.015560027,0
1952,North Carolina\Madison,237,159,198,159,17226,10226,39,0,159,159,0.015548602,1
2737,Texas\Runnels,3484,4505,2771,3854,264780,247945,713,651,3854,3854,0.01554377,1
2424,South Dakota\Moody,2430,3227,2430,3227,235483,208768,0,0,3227,3227,0.01545735,1
1878,New York\Schenectady,399,140,399,140,10530,9083,0,0,140,140,0.01541341,1
2088,Ohio\Huron,3002,3242,3002,3211,189541,208716,0,31,3211,3211,0.015384542,1
2870,Virginia\Franklin,872,893,864,893,66792,58191,8,0,893,893,0.015346016,1
2302,Pennsylvania\Northumberland,1057,1422,1034,1422,110295,92754,23,0,1422,1422,0.015330875,1
32,Alabama\Greene,286,334,152,0,36324,21842,134,0,334,334,0.01529164,0
2339,South Carolina\Chester,0,514,0,290,29698,18998,70,224,290,290,0.015264765,1
1404,Mississippi\Calhoun,1848,1216,1848,0,89916,80088,0,0,1216,1216,0.015183298,0
653,Illinois\Peoria,2827,3198,2827,0,220243,211085,0,0,3198,3198,0.015150295,0
1890,New York\Wayne,2197,1900,2165,1900,119662,126311,32,0,1900,1900,0.015042237,1
1142,Louisiana\Plaquemines,1577,128,161,0,38350,8511,1416,0,128,128,0.015039361,0
2041,North Dakota\Steele,1875,5968,1875,5968,366696,396979,0,0,5968,5968,0.015033541,1
1269,Michigan\Lapeer,2408,2100,2253,2056,135328,137097,155,44,2056,2056,0.014996681,1
2111,Ohio\Ottawa,179,1549,0,1549,107052,103623,0,0,1549,1549,0.014948419,1
2291,Pennsylvania\Lebanon,1276,1463,1264,1441,89566,97431,12,22,1441,1441,0.014789954,1
2551,Texas\Bell,2746,3084,1787,2515,183837,170451,959,569,2515,2515,0.014754974,1
2881,Virginia\Henry,524,137,0,137,15342,9299,0,0,137,137,0.014732767,1
1192,Maryland\Carroll,1035,1431,942,0,103180,97248,93,0,1431,1431,0.014714956,0
2583,Texas\Comal,517,422,208,206,37467,14070,309,216,206,206,0.01464108,1
2681,Texas\Lee,1433,940,0,646,68291,44136,0,294,646,646,0.014636578,1
2703,Texas\Milam,2784,2486,2311,2090,205120,143011,473,396,2090,2090,0.01461426,1
1271,Michigan\Lenawee,5948,4369,5876,0,304668,299349,72,0,4369,4369,0.014595004,0
1392,Minnesota\Watonwan,1613,3241,1613,3241,252946,223268,0,0,3241,3241,0.014516187,1
2351,South Carolina\Greenwood,115,184,83,0,18022,12677,32,0,184,184,0.014514475,0
2786,Texas\Wise,2461,2775,1648,1654,133972,114295,813,1121,1654,1654,0.014471324,1
502,Georgia\Taliaferro,0,52,0,52,5330,3599,0,0,52,52,0.014448458,1
1250,Michigan\Genesee,1082,1547,1021,1482,106588,102603,61,65,1482,1482,0.014444022,1
398,Georgia\Chattooga,265,186,0,186,16069,12956,0,0,186,186,0.014356283,1
1281,Michigan\Midland,542,996,530,0,69585,69506,12,0,996,996,0.014329698,0
1368,Minnesota\Pipestone,2522,2944,2522,2944,211637,206004,0,0,2944,2944,0.014290985,1
2227,Oregon\Gilliam,7460,6500,5878,4713,294573,331667,1582,1787,4713,4713,0.014210036,1
114,Arkansas\Franklin,817,636,0,636,52763,44783,0,0,636,636,0.014201818,1
1174,Maine\Hancock,112,170,112,0,16977,11989,0,0,170,170,0.014179665,0
2381,South Dakota\Brule,5534,3741,5534,3741,287619,263853,0,0,3741,3741,0.014178349,1
2446,Tennessee\Blount,497,604,481,0,51547,42753,16,0,604,604,0.014127664,0
2281,Pennsylvania\Franklin,1871,2845,1871,2845,184991,201822,0,0,2845,2845,0.01409658,1
1054,Kentucky\Logan,539,2706,539,2706,198382,192361,0,0,2706,2706,0.014067301,1
1450,Mississippi\Oktibbeha,789,304,0,304,26229,21652,0,0,304,304,0.014040273,1
2883,Virginia\Isle of Wight,702,702,0,0,50641,50029,0,0,702,702,0.014031862,0
3055,Wisconsin\Green,2590,3377,2473,3345,240009,238606,117,32,3345,3345,0.014018927,1
2104,Ohio\Miami,2074,2308,2074,0,179034,164828,0,0,2308,2308,0.014002475,0
650,Illinois\Morgan,3206,3807,3206,3807,281053,272320,0,0,3807,3807,0.013979877,1
117,Arkansas\Grant,80,144,80,0,11825,10310,0,0,144,144,0.013967022,0
2903,Virginia\Orange,627,564,0,0,45202,40460,0,0,564,564,0.013939694,0
2096,Ohio\Lorain,1255,1429,1249,0,103949,102718,6,0,1429,1429,0.013911875,0
5,Alabama\Blount,568,516,568,0,46735,37147,0,0,516,516,0.013890758,0
1831,New York,68010,59807,65891,58463,4314954,4217041,2119,1344,58463,58463,0.013863512,1
1321,Minnesota\Chippewa,2718,4295,0,4295,337702,310612,0,0,4295,4295,0.01382754,1
874,Iowa\Woodbury,10579,5306,0,0,385307,384576,0,0,5306,5306,0.013797013,0
2025,North Dakota\Morton,6616,7562,0,7562,548569,549123,0,0,7562,7562,0.013771049,1
2160,Oklahoma\Dewey,3129,2368,1966,2268,173736,165124,1163,100,2268,2268,0.013735132,1
1501,Missouri\Chariton,2512,3876,2309,0,261624,282647,203,0,3876,3876,0.013713218,0
1499,Missouri\Cass,5256,2812,4988,2771,205033,202443,268,41,2771,2771,0.013687803,1
2919,Virginia\Shenandoah,756,719,725,719,60247,52726,31,0,719,719,0.013636536,1
770,Indiana\Warren,4357,2132,4357,0,178681,156497,0,0,2132,2132,0.013623264,0
1035,Kentucky\Henry,944,791,944,791,72729,58161,0,0,791,791,0.013600179,1
132,Arkansas\Logan,1882,907,0,0,64105,66796,0,0,907,907,0.013578657,0
2115,Ohio\Pike,81,722,0,722,38052,53230,0,0,722,722,0.01356378,1
1513,Missouri\Dent,235,435,0,0,41087,32090,0,0,435,435,0.013555625,0
1011,Kentucky\Crittenden,301,1124,301,1124,84407,83004,0,0,1124,1124,0.013541516,1
1334,Minnesota\Goodhue,2828,4468,2828,0,322809,329994,0,0,4468,4468,0.01353964,0
430,Georgia\Franklin,532,308,0,266,25948,19736,0,42,266,266,0.013477908,1
851,Iowa\Palo Alto,4390,4831,4390,4591,337419,340756,0,240,4591,4591,0.013472984,1
2692,Texas\McLennan,2937,3509,2701,3279,241607,243981,236,230,3279,3279,0.013439571,1
1418,Mississippi\Greene,107,218,107,0,13022,16242,0,0,218,218,0.013421992,0
2102,Ohio\Meigs,671,329,0,0,28321,24620,0,0,329,329,0.013363119,0
2150,Oklahoma\Choctaw,527,1050,0,840,83849,63159,0,210,840,840,0.013299767,1
2841,Virginia\Amelia,561,375,407,375,33503,28214,154,0,375,375,0.013291274,1
2476,Tennessee\Hardeman,0,1051,0,1039,78720,78235,0,12,1039,1039,0.013280501,1
666,Illinois\Schuyler,0,1652,0,1652,138362,124557,0,0,1652,1652,0.013263004,1
449,Georgia\Jackson,617,255,605,234,24479,17684,12,21,234,234,0.0132323,1
1641,Montana\Sheridan,7357,9180,0,0,716256,695965,0,0,9180,9180,0.013190318,0
2292,Pennsylvania\Lehigh,1189,831,1189,0,72737,63225,0,0,831,831,0.013143535,0
1007,Kentucky\Christian,2656,3310,0,3310,239355,252280,0,0,3310,3310,0.013120342,1
2308,Pennsylvania\Snyder,1027,782,1020,0,65426,59679,7,0,782,782,0.013103437,0
2631,Texas\Guadalupe,1094,1941,893,1468,125959,112126,201,473,1468,1468,0.013092414,1
1994,North Carolina\Yancey,113,81,0,81,9987,6194,0,0,81,81,0.013077171,1
2658,Texas\Jasper,310,357,276,213,20192,16337,34,144,213,213,0.013037889,1
1564,Missouri\Polk,1254,1347,0,1338,144053,102638,0,9,1338,1338,0.013036107,1
1175,Maine\Kennebec,136,427,0,427,38281,32770,0,0,427,427,0.013030211,1
2274,Pennsylvania\Cumberland,1191,1595,1162,1558,123109,119664,29,37,1558,1558,0.013019789,1
1401,Mississippi\Attala,435,376,0,376,37671,29086,0,0,376,376,0.012927181,1
1180,Maine\Piscataquis,148,160,98,160,9255,12387,50,0,160,160,0.012916768,1
3108,Wyoming\Campbell,4023,1814,0,0,170423,140702,0,0,1814,1814,0.012892496,0
1818,New Mexico\Quay,18781,6966,10200,2785,245859,216182,8581,4181,2785,2785,0.012882664,1
2549,Texas\Baylor,3303,1890,0,0,141716,146774,0,0,1890,1890,0.01287694,0
2200,Oklahoma\Pontotoc,788,888,0,0,112838,69016,0,0,888,888,0.012866582,0
935,Kansas\Marion,3053,4358,3053,4358,337552,341358,0,0,4358,4358,0.012766656,1
898,Kansas\Dickinson,5015,4269,5015,4269,350401,335353,0,0,4269,4269,0.01272987,1
2884,Virginia\James City,29,38,29,38,2990,2987,0,0,38,38,0.012721794,1
2144,Oklahoma\Blaine,5845,3139,5309,0,286049,247107,536,0,3139,3139,0.012702999,0
2486,Tennessee\Jefferson,0,479,117,479,49249,37711,0,0,479,479,0.012701864,1
1872,New York\Queens,5,5,5,5,0,394,0,0,5,5,0.012690355,1
2914,Virginia\Roanoke,93,96,93,96,8793,7624,0,0,96,96,0.012591815,1
1017,Kentucky\Fayette,533,1110,443,508,61715,40354,90,602,508,508,0.012588591,1
1885,New York\Tioga,377,672,377,637,53816,50688,0,35,637,637,0.012567077,1
2267,Pennsylvania\Centre,643,1060,581,0,86137,84871,62,0,1060,1060,0.012489543,0
1163,Louisiana\Washington,260,376,0,356,44961,28627,0,20,356,356,0.012435812,1
1865,New York\Onondaga,1605,1316,1598,1262,106223,101800,7,54,1262,1262,0.012396857,1
2721,Texas\Parker,1525,2211,1206,1160,103759,93854,319,1051,1160,1160,0.012359622,1
1869,New York\Oswego,1060,555,0,555,49041,45419,0,0,555,555,0.012219556,1
1506,Missouri\Cole,448,860,426,823,79523,67524,22,37,823,823,0.012188259,1
1212,Massachusetts\Berkshire,152,223,0,223,22574,18381,0,0,223,223,0.012132093,1
643,Illinois\Marshall,2332,2221,2332,2221,183523,183698,0,0,2221,2221,0.012090496,1
769,Indiana\Wabash,1087,2084,1087,2084,180439,172916,0,0,2084,2084,0.012052095,1
2018,North Dakota\LaMoure,6556,7365,6211,7365,569003,611292,345,0,7365,7365,0.012048252,1
1975,North Carolina\Rutherford,392,237,269,194,23480,16149,123,43,194,194,0.012013128,1
413,Georgia\Dawson,83,48,0,27,4344,2250,0,21,27,27,0.012,1
2613,Texas\Fisher,4569,2553,4297,2517,239434,210142,272,36,2517,2517,0.011977615,1
2106,Ohio\Montgomery,163,1248,155,1248,97463,104672,8,0,1248,1248,0.011922959,1
1058,Kentucky\McLean,0,1150,0,0,117621,96487,0,0,1150,1150,0.011918704,0
1589,Missouri\Warren,906,1056,0,1015,85180,85315,0,41,1015,1015,0.011897087,1
1859,New York\Monroe,1599,945,1576,0,105731,79522,23,0,945,945,0.011883504,0
3064,Wisconsin\La Crosse,859,1031,859,1031,87654,86855,0,0,1031,1031,0.011870359,1
1879,New York\Schoharie,527,650,0,650,53031,54964,0,0,650,650,0.011825922,1
1093,Kentucky\Todd,962,1492,0,1492,136214,126649,0,0,1492,1492,0.01178059,1
1966,North Carolina\Perquimans,1479,853,0,853,63558,72423,0,0,853,853,0.011778026,1
626,Illinois\Kane,2936,1817,2936,1817,181983,154299,0,0,1817,1817,0.011775838,1
1832,New York\Albany,368,429,368,0,32020,36457,0,0,429,429,0.011767287,0
1421,Mississippi\Harrison,120,66,60,66,5747,5643,60,0,66,66,0.011695906,1
2204,Oklahoma\Rogers,811,1034,706,840,100713,71826,105,194,840,840,0.011694929,1
945,Kansas\Ness,2511,4813,0,4813,389049,412300,0,0,4813,4813,0.011673539,1
2399,South Dakota\Grant,4016,3385,4016,3385,263680,290676,0,0,3385,3385,0.011645268,1
1089,Kentucky\Shelby,1524,1295,1524,0,124208,111258,0,0,1295,1295,0.011639612,0
2275,Pennsylvania\Dauphin,355,697,0,697,66235,59986,0,0,697,697,0.011619378,1
1205,Maryland\Somerset,358,423,0,0,35392,36407,0,0,423,423,0.011618645,0
2266,Pennsylvania\Carbon,132,155,0,155,12704,13350,0,0,155,155,0.011610487,1
2553,Texas\Blanco,1019,490,314,256,43597,22076,705,234,256,256,0.011596304,1
1020,Kentucky\Franklin,397,348,397,0,34904,30063,0,0,348,348,0.011575691,0
1943,North Carolina\Iredell,1141,871,734,0,69412,75356,407,0,871,871,0.011558469,0
1665,Nebraska\Cass,2959,3513,0,3513,246870,304275,0,0,3513,3513,0.011545477,1
1193,Maryland\Cecil,1122,632,0,632,60147,54778,0,0,632,632,0.011537479,1
1420,Mississippi\Hancock,442,55,442,55,10084,4768,0,0,55,55,0.011535235,1
3045,Wisconsin\Dane,5958,4558,5891,4558,417244,396321,67,0,4558,4558,0.011500778,1
2173,Oklahoma\Johnston,692,470,262,0,57800,40929,430,0,470,470,0.0114833,0
1044,Kentucky\Knox,8,110,8,110,17872,9583,0,0,110,110,0.01147866,1
1907,North Carolina\Cabarrus,375,348,354,342,34570,29887,21,6,342,342,0.011443102,1
916,Kansas\Harper,1767,3760,1767,0,315794,329027,0,0,3760,3760,0.011427634,0
2420,South Dakota\Meade,6647,3993,5917,0,520398,349829,730,0,3993,3993,0.011414148,0
2719,Texas\Palo Pinto,601,712,496,629,84942,55421,105,83,629,629,0.011349488,1
1427,Mississippi\Jackson,155,162,155,0,17229,14293,0,0,162,162,0.01133422,0
1198,Maryland\Harford,423,458,423,458,49203,40421,0,0,458,458,0.011330744,1
2686,Texas\Live Oak,2063,734,1801,631,90632,55742,262,103,631,631,0.01132001,1
1767,New Hampshire\Cheshire,84,104,84,0,11822,9206,0,0,104,104,0.01129698,0
983,Kentucky,58730,73573,58221,71168,7278098,6336247,509,2405,71168,71168,0.011231885,1
603,Illinois\Du Page,0,66,0,0,6388,5878,0,0,66,66,0.011228309,0
1873,New York\Rensselaer,1008,644,974,568,45175,50643,34,76,568,568,0.011215765,1
674,Illinois\Wabash,1119,1057,1119,1057,104890,94366,0,0,1057,1057,0.011201068,1
440,Georgia\Hall,170,137,117,0,15352,12250,53,0,137,137,0.011183673,0
2395,South Dakota\Douglas,2497,2148,0,2148,157298,192294,0,0,2148,2148,0.011170395,1
2656,Texas\Jack,717,400,620,0,72042,35814,97,0,400,400,0.011168817,0
907,Kansas\Franklin,1580,2241,0,0,167592,200819,0,0,2241,2241,0.011159303,0
2776,Texas\Washington,1438,1438,1108,997,90410,89366,330,441,997,997,0.011156368,1
520,Georgia\Warren,0,102,0,102,10662,9155,0,0,102,102,0.011141453,1
123,Arkansas\Izard,243,314,243,0,38036,28314,0,0,314,314,0.01108992,0
2861,Virginia\Culpeper,1266,641,0,0,56111,58018,0,0,641,641,0.011048295,0
2897,Virginia\Montgomery,383,349,0,349,30219,31639,0,0,349,349,0.01103069,1
2590,Texas\Crockett,524,88,0,0,18637,7985,0,0,88,88,0.011020664,0
2720,Texas\Panola,371,697,311,425,50745,38625,60,272,425,425,0.011003236,1
2284,Pennsylvania\Huntingdon,197,849,0,0,73043,77210,0,0,849,849,0.010995985,0
768,Indiana\Vigo,2131,1112,0,1112,103045,101345,0,0,1112,1112,0.010972421,1
2452,Tennessee\Cheatham,345,226,345,226,30323,20809,0,0,226,226,0.010860685,1
2384,South Dakota\Campbell,1080,2290,1080,2290,205605,210950,0,0,2290,2290,0.010855653,1
1497,Missouri\Carroll,2987,3480,0,3480,294730,320850,0,0,3480,3480,0.01084619,1
2061,Ohio\Clark,1475,1617,1475,1617,153465,149820,0,0,1617,1617,0.010792952,1
1650,Montana\Wibaux,1054,1464,1054,1464,159984,135740,0,0,1464,1464,0.010785325,1
1091,Kentucky\Spencer,550,355,550,334,36145,31157,0,21,334,334,0.010719902,1
468,Georgia\Madison,271,209,220,209,25316,19514,51,0,209,209,0.010710259,1
2268,Pennsylvania\Chester,1659,1211,1622,1145,117145,107125,37,66,1145,1145,0.010688448,1
693,Indiana\Cass,3129,1930,3129,1930,208479,181564,0,0,1930,1930,0.010629861,1
733,Indiana\Marion,367,170,362,0,14233,16018,5,0,170,170,0.01061306,0
2731,Texas\Red River,2798,2808,1448,1005,104474,94700,1350,1803,1005,1005,0.01061246,1
2869,Virginia\Fluvanna,265,144,0,144,18136,13633,0,0,144,144,0.010562605,1
2773,Texas\Walker,885,522,499,408,37146,38639,386,114,408,408,0.010559279,1
1196,Maryland\Frederick,1010,1376,937,1335,143661,127130,73,41,1335,1335,0.010501062,1
2214,Oklahoma\Woods,1984,2756,0,2418,303751,231102,0,338,2418,2418,0.010462912,1
377,Georgia\Banks,672,149,87,0,11885,14320,585,0,149,149,0.010405028,0
1346,Minnesota\Lac qui Parle,4970,4243,0,4243,362069,407869,0,0,4243,4243,0.01040285,1
541,Idaho\Benewah,254,913,0,847,83413,81697,0,66,847,847,0.010367578,1
2559,Texas\Brewster,481,488,0,0,50084,47141,0,0,488,488,0.010351923,0
2331,South Carolina\Anderson,664,609,490,481,63764,46533,174,128,481,481,0.01033675,1
1258,Michigan\Ingham,2341,1735,2260,1724,155695,167391,81,11,1724,1724,0.01029924,1
1336,Minnesota\Hennepin,614,559,586,0,49143,54284,28,0,559,559,0.010297694,0
2298,Pennsylvania\Monroe,97,134,97,134,14308,13049,0,0,134,134,0.010268986,1
2612,Texas\Fayette,1313,1087,1139,979,122464,95385,174,108,979,979,0.010263668,1
1189,Maryland\Baltimore,868,458,0,458,50941,44642,0,0,458,458,0.010259397,1
2666,Texas\Kaufman,1585,1360,1352,1331,155113,130532,233,29,1331,1331,0.010196733,1
2195,Oklahoma\Osage,435,1338,0,0,156177,131371,0,0,1338,1338,0.010184896,0
2836,Vermont\Windsor,116,239,116,239,27600,23585,0,0,239,239,0.010133559,1
735,Indiana\Martin,0,395,0,0,40235,39028,0,0,395,395,0.010120939,0
139,Arkansas\Montgomery,882,336,414,210,27067,20752,468,126,210,210,0.010119507,1
1536,Missouri\Lewis,2259,2028,2259,2028,178257,201259,0,0,2028,2028,0.010076568,1
2190,Oklahoma\Noble,833,1946,0,1946,215845,193284,0,0,1946,1946,0.010068086,1
2767,Texas\Upshur,1478,433,521,0,60176,43139,957,0,433,433,0.010037321,0
1412,Mississippi\Copiah,881,184,0,184,30066,18390,0,0,184,184,0.010005438,1
1955,North Carolina\Mitchell,93,43,0,43,6626,4305,0,0,43,43,0.009988386,1
1568,Missouri\Randolph,738,1086,0,0,119856,109074,0,0,1086,1086,0.009956543,0
1993,North Carolina\Yadkin,837,528,752,0,59676,53471,85,0,528,528,0.009874511,0
2407,South Dakota\Hutchinson,3348,4028,0,4028,394680,409677,0,0,4028,4028,0.009832136,1
1240,Michigan\Charlevoix,232,204,214,0,23933,20790,18,0,204,204,0.00981241,0
1315,Minnesota\Big Stone,2228,2107,2228,2107,223813,215735,0,0,2107,2107,0.009766612,1
2278,Pennsylvania\Erie,1397,939,1155,939,101698,96210,242,0,939,939,0.0097599,1
1190,Maryland\Calvert,124,207,124,0,14384,21244,0,0,207,207,0.009743928,0
525,Georgia\White,140,60,0,57,7004,5861,0,3,57,57,0.009725303,1
936,Kansas\Marshall,2529,2934,2529,2934,338554,301711,0,0,2934,2934,0.009724538,1
1207,Maryland\Washington,857,829,0,0,81623,85270,0,0,829,829,0.009722059,0
1183,Maine\Waldo,96,241,96,0,24336,24840,0,0,241,241,0.009702093,0
3016,West Virginia\Putnam,157,118,142,118,15013,12233,15,0,118,118,0.009646039,1
293,Connecticut\Litchfield,326,358,279,0,39172,37213,47,0,358,358,0.009620294,0
1516,Missouri\Franklin,1129,1264,850,1240,150258,128920,279,24,1240,1240,0.009618368,1
1794,New Jersey\Sussex,454,268,410,268,32949,27908,44,0,268,268,0.009602981,1
2516,Tennessee\Rutherford,1389,682,1372,675,77912,70378,17,7,675,675,0.009591065,1
2535,Tennessee\Williamson,851,517,843,500,69786,52354,8,17,500,500,0.009550369,1
2599,Texas\DeWitt,1213,618,510,474,78581,49680,703,144,474,474,0.009541063,1
672,Illinois\Union,137,762,137,757,74976,79343,0,5,757,757,0.009540854,1
1621,Montana\Liberty,11265,5915,0,5764,637568,604361,0,151,5764,5764,0.009537346,1
1577,Missouri\Saline,1484,3456,996,0,340155,362921,488,0,3456,3456,0.009522734,0
1369,Minnesota\Polk,10439,9423,0,9423,976367,991405,0,0,9423,9423,0.009504693,1
2890,Virginia\Loudoun,3533,580,3507,533,73593,56203,26,47,533,533,0.00948348,1
2907,Virginia\Powhatan,28,100,28,100,11606,10551,0,0,100,100,0.009477775,1
2077,Ohio\Geauga,355,308,335,308,29541,32671,20,0,308,308,0.009427321,1
2488,Tennessee\Knox,527,230,527,0,35118,24489,0,0,230,230,0.009391972,0
121,Arkansas\Howard,926,513,415,216,34747,23156,511,297,216,216,0.009328036,1
2754,Texas\Stonewall,2399,741,0,0,101704,79495,0,0,741,741,0.009321341,0
1103,Kentucky\Woodford,614,333,0,323,50745,34655,0,10,323,323,0.009320444,1
2858,Virginia\Chesterfield,185,64,185,64,6556,6869,0,0,64,64,0.009317222,1
1930,North Carolina\Gaston,76,141,0,0,14579,15142,0,0,141,141,0.009311848,0
517,Georgia\Walker,271,264,215,0,22876,28498,56,0,264,264,0.009263808,0
2163,Oklahoma\Garvin,812,1096,714,1027,137311,110970,98,69,1027,1027,0.009254754,1
2504,Tennessee\Montgomery,773,713,773,713,87812,77103,0,0,713,713,0.00924737,1
2891,Virginia\Louisa,278,278,0,278,30147,30067,0,0,278,278,0.009246017,1
677,Illinois\Wayne,2454,2944,2454,2944,284346,318671,0,0,2944,2944,0.009238368,1
3081,Wisconsin\Polk,976,1477,976,0,172203,159940,0,0,1477,1477,0.009234713,0
2003,North Dakota\Burleigh,5688,4564,0,4564,476888,494684,0,0,4564,4564,0.009226092,1
1928,North Carolina\Forsyth,436,181,376,0,24290,19695,60,0,181,181,0.00919015,0
2132,Ohio\Warren,260,737,248,0,71975,80238,12,0,737,737,0.009185174,0
1245,Michigan\Crawford,9,13,0,7,788,766,0,6,7,7,0.009138381,1
492,Georgia\Richmond,37,99,37,36,6286,3941,0,63,36,36,0.009134737,1
1978,North Carolina\Stanly,691,493,0,0,58192,54510,0,0,493,493,0.009044212,0
2482,Tennessee\Hickman,50,365,0,355,43685,39329,0,10,355,355,0.009026418,1
3047,Wisconsin\Door,778,851,774,0,98994,94302,4,0,851,851,0.009024199,0
378,Georgia\Barrow,95,59,58,59,9978,6543,37,0,59,59,0.00901727,1
2859,Virginia\Clarke,515,249,515,249,32530,27615,0,0,249,249,0.009016839,1
483,Georgia\Pickens,272,36,102,36,8047,4000,170,0,36,36,0.009,1
1440,Mississippi\Lincoln,238,180,81,0,34280,20109,157,0,180,180,0.008951216,0
2029,North Dakota\Pembina,3671,5662,3671,5662,601742,632836,0,0,5662,5662,0.008947026,1
691,Indiana\Brown,61,59,61,0,8215,6624,0,0,59,59,0.008907005,0
2413,South Dakota\Lake,2799,1844,2799,1844,260009,207264,0,0,1844,1844,0.008896866,1
2004,North Dakota\Cass,11718,9292,11718,9292,986345,1044517,0,0,9292,9292,0.008895978,1
1123,Louisiana\East Feliciana,987,231,180,0,33096,25979,807,0,231,231,0.008891797,0
899,Kansas\Doniphan,1610,1187,1610,1187,180578,133827,0,0,1187,1187,0.00886966,1
2259,Pennsylvania\Berks,1260,1633,1213,1615,170760,182303,47,18,1615,1615,0.008858878,1
2176,Oklahoma\Kiowa,2615,2677,2294,2677,292485,302346,321,0,2677,2677,0.008854094,1
631,Illinois\La Salle,3845,5013,3825,0,614381,569010,20,0,5013,5013,0.008810038,0
2023,North Dakota\McLean,6748,7403,0,7367,884687,838696,0,36,7367,7367,0.008783874,1
2415,South Dakota\Lincoln,2062,2889,2062,2881,303444,329906,0,8,2881,2881,0.008732791,1
2010,North Dakota\Emmons,5001,3872,5001,3872,529824,443946,0,0,3872,3872,0.008721781,1
442,Georgia\Haralson,80,47,0,0,11250,5396,0,0,47,47,0.008710156,0
1199,Maryland\Howard,209,182,0,0,18685,20903,0,0,182,182,0.008706884,0
764,Indiana\Tipton,61,1205,61,0,159400,138655,0,0,1205,1205,0.008690635,0
140,Arkansas\Nevada,21,140,21,140,23821,16121,0,0,140,140,0.008684325,1
2639,Texas\Harrison,800,464,679,354,52273,40859,121,110,354,354,0.008663942,1
3075,Wisconsin\Oconto,1271,1221,0,0,146751,141002,0,0,1221,1221,0.008659452,0
1953,North Carolina\Martin,1187,767,0,767,74052,88690,0,0,767,767,0.0086481,1
2618,Texas\Freestone,346,424,328,407,80055,47139,18,17,407,407,0.00863404,1
349,Florida\Okaloosa,421,161,374,0,24335,18649,47,0,161,161,0.008633171,0
2293,Pennsylvania\Luzerne,442,295,439,0,38601,34383,3,0,295,295,0.008579821,0
1531,Missouri\Johnson,1369,1886,0,0,244721,219868,0,0,1886,1886,0.008577874,0
53,Alabama\Perry,135,338,115,0,39723,39485,20,0,338,338,0.008560213,0
1572,Missouri\St. Charles,899,1075,767,1035,121847,120971,132,40,1035,1035,0.00855577,1
600,Illinois\De Kalb,75,3279,75,3279,356193,383524,0,0,3279,3279,0.008549661,1
1298,Michigan\Saginaw,1755,2346,1669,0,287217,274451,86,0,2346,2346,0.008547974,0
2935,Virginia\Virginia Beach City,194,180,0,180,21542,21212,0,0,180,180,0.008485763,1
2765,Texas\Trinity,310,152,134,0,27340,17913,176,0,152,152,0.008485457,0
2733,Texas\Refugio,0,1235,0,732,94329,86511,9,503,732,732,0.008461352,1
641,Illinois\Madison,1035,2364,1035,2338,284553,276513,0,26,2338,2338,0.008455299,1
620,Illinois\Jackson,397,1461,379,1461,177358,172948,18,0,1461,1461,0.008447626,1
2484,Tennessee\Humphreys,47,344,47,0,52652,40760,0,0,344,344,0.008439647,0
2253,Pennsylvania,37786,38990,36759,38224,4870287,4546052,1027,766,38224,38224,0.008408175,1
1646,Montana\Toole,4204,6275,0,6275,725052,747301,0,0,6275,6275,0.008396884,1
2448,Tennessee\Campbell,0,96,0,0,14872,11486,0,0,96,96,0.008358001,0
2555,Texas\Bosque,1043,656,526,587,96204,70328,517,69,587,587,0.008346604,1
2180,Oklahoma\Logan,1600,1114,1177,0,152386,133749,423,0,1114,1114,0.008329034,0
615,Illinois\Hancock,1282,2625,1282,0,322151,315713,0,0,2625,2625,0.008314513,0
263,Colorado\Lincoln,9652,4807,9652,0,575968,581583,0,0,4807,4807,0.008265372,0
2015,North Dakota\Griggs,4021,2826,3828,2826,322538,342371,193,0,2826,2826,0.008254204,1
1603,Montana\Chouteau,12088,10379,11176,0,1310448,1260269,912,0,10379,10379,0.008235543,0
986,Kentucky\Anderson,89,242,89,242,43657,29432,0,0,242,242,0.008222343,1
1317,Minnesota\Brown,3042,2423,3042,2423,318799,296379,0,0,2423,2423,0.008175343,1
2649,Texas\Hopkins,11595,1331,10601,1044,142997,127723,994,287,1044,1044,0.008173939,1
1248,Michigan\Eaton,1431,1458,1417,1436,176885,176088,14,22,1436,1436,0.008155013,1
2391,South Dakota\Davison,1599,1713,1599,1713,214888,210170,0,0,1713,1713,0.008150545,1
134,Arkansas\Madison,618,468,533,0,73146,57531,85,0,468,468,0.008134745,0
2834,Vermont\Washington,151,201,151,171,20747,21061,0,30,171,171,0.008119273,1
1836,New York\Cattaraugus,524,929,0,790,91562,97304,0,139,790,790,0.008118885,1
2934,Virginia\Suffolk,616,413,0,0,53760,50932,0,0,413,413,0.008108851,0
1616,Montana\Hill,9107,9437,8277,0,1202924,1168871,830,0,9437,9437,0.008073603,0
855,Iowa\Pottawattamie,1996,3889,0,0,434777,481829,0,0,3889,3889,0.008071328,0
610,Illinois\Fulton,850,2149,850,2149,280081,266405,0,0,2149,2149,0.008066665,1
2011,North Dakota\Foster,3279,2598,3279,2535,336125,314321,0,63,2535,2535,0.008065004,1
2101,Ohio\Medina,376,602,0,583,73743,72363,0,19,583,583,0.008056604,1
1488,Missouri\Benton,294,701,0,0,88955,87181,0,0,701,701,0.008040743,0
1388,Minnesota\Wabasha,603,1426,453,1426,181667,177784,150,0,1426,1426,0.008020969,1
2288,Pennsylvania\Lackawanna,258,129,249,129,21375,16101,9,0,129,129,0.008011925,1
2403,South Dakota\Hand,2400,4527,2400,0,506248,565623,0,0,4527,4527,0.008003564,0
1995,North Dakota,236138,218407,233171,217057,27527180,27147240,2967,1350,217057,217057,0.007995546,1
3052,Wisconsin\Fond du Lac,874,2091,874,2091,279922,262142,0,0,2091,2091,0.007976593,1
2042,North Dakota\Stutsman,8663,8168,8663,8168,931661,1030565,0,0,8168,8168,0.007925749,1
2830,Vermont\Lamoille,61,100,61,100,17325,12621,0,0,100,100,0.007923302,1
2153,Oklahoma\Coal,469,356,0,0,64234,45089,0,0,356,356,0.007895496,0
694,Indiana\Clark,421,428,421,0,61027,54233,0,0,428,428,0.007891874,0
1487,Missouri\Bates,1196,2193,751,0,277724,278213,445,0,2193,2193,0.00788245,0
497,Georgia\Spalding,175,40,171,40,7087,5075,4,0,40,40,0.007881773,1
1848,New York\Franklin,357,589,357,589,69691,74818,0,0,589,589,0.007872437,1
2706,Texas\Montague,584,582,374,582,120149,74027,210,0,582,582,0.007861996,1
582,Illinois\Adams,1561,2311,0,0,284687,294180,0,0,2311,2311,0.007855735,0
2538,Texas\Anderson,2325,896,1607,552,74892,70333,718,344,552,552,0.007848378,1
2371,South Carolina\Union,117,70,53,70,9537,8977,64,0,70,70,0.007797705,1
22,Alabama\Cullman,780,454,751,0,87754,58390,29,0,454,454,0.007775304,0
657,Illinois\Pope,0,339,0,339,30871,43600,0,0,339,339,0.007775229,1
938,Kansas\Miami,1707,1334,1707,1288,155008,166460,0,46,1288,1288,0.007737595,1
2877,Virginia\Greensville,0,246,0,246,29578,31915,0,0,246,246,0.007707974,1
2438,South Dakota\Walworth,2478,1894,0,1894,238320,245726,0,0,1894,1894,0.007707772,1
1359,Minnesota\Mower,1144,3239,1144,0,391611,422921,0,0,3239,3239,0.007658641,0
1422,Mississippi\Hinds,404,473,304,0,74943,61818,100,0,473,473,0.007651493,0
2933,Virginia\Chesapeake City,239,283,228,0,43217,36990,11,0,283,283,0.007650716,0
1376,Minnesota\Rock,1238,1929,1238,1929,251320,252671,0,0,1929,1929,0.007634434,1
1277,Michigan\Marquette,104,70,104,70,10405,9186,0,0,70,70,0.007620292,1
1769,New Hampshire\Grafton,97,131,97,131,24887,17195,0,0,131,131,0.007618494,1
46,Alabama\Marengo,10,402,0,250,36615,32830,0,152,250,250,0.007614986,1
2263,Pennsylvania\Butler,665,587,649,587,78262,77093,16,0,587,587,0.00761418,1
1944,North Carolina\Jackson,86,56,0,47,5403,6173,0,9,47,47,0.007613802,1
2491,Tennessee\Lawrence,533,803,514,803,120908,105493,19,0,803,803,0.007611879,1
2316,Pennsylvania\Washington,403,755,369,656,100987,86359,34,99,656,656,0.007596197,1
1028,Kentucky\Greenup,70,133,0,0,29485,17513,0,0,133,133,0.007594358,0
2194,Oklahoma\Okmulgee,860,670,0,592,100027,77954,0,78,592,592,0.007594222,1
2522,Tennessee\Stewart,266,157,0,157,19431,20694,0,0,157,157,0.00758674,1
1003,Kentucky\Carlisle,449,603,0,0,73914,79596,0,0,603,603,0.007575758,0
1605,Montana\Daniels,1530,4053,0,0,591563,536003,0,0,4053,4053,0.007561525,0
2372,South Carolina\Williamsburg,913,795,787,694,105553,91829,126,101,694,694,0.007557525,1
2410,South Dakota\Jerauld,1314,1370,1314,1370,185566,181643,0,0,1370,1370,0.007542267,1
2380,South Dakota\Brown,7482,6430,7482,0,827589,854474,0,0,6430,6430,0.007525097,0
995,Kentucky\Bracken,329,218,329,218,43080,28999,0,0,218,218,0.007517501,1
2665,Texas\Karnes,1390,905,782,620,104454,82701,608,285,620,620,0.007496886,1
1534,Missouri\Lafayette,2060,1828,2060,0,262374,244505,0,0,1828,1828,0.00747633,0
1530,Missouri\Jefferson,438,305,428,271,39350,36264,10,34,271,271,0.007472976,1
2567,Texas\Callahan,633,704,548,649,104308,87203,85,55,649,649,0.007442405,1
159,Arkansas\Stone,223,164,223,0,38480,22062,0,0,164,164,0.007433596,0
1073,Kentucky\Nelson,1578,721,1541,0,104777,97168,37,0,721,721,0.007420138,0
990,Kentucky\Bell,74,13,74,0,4085,1753,0,0,13,13,0.007415859,0
2272,Pennsylvania\Columbia,516,631,510,0,88103,85144,6,0,631,631,0.007410974,0
1582,Missouri\Shelby,1448,1563,0,1563,201344,210951,0,0,1563,1563,0.007409304,1
1147,Louisiana\Sabine,167,89,0,0,13731,12030,0,0,89,89,0.007398171,0
2828,Vermont\Franklin,188,593,128,0,85077,80167,60,0,593,593,0.007397059,0
1077,Kentucky\Owen,444,338,444,0,69253,45754,0,0,338,338,0.007387332,0
2492,Tennessee\Lewis,0,70,0,70,13995,9565,0,0,70,70,0.007318348,1
585,Illinois\Boone,1809,944,0,928,128769,126852,0,16,928,928,0.007315612,1
903,Kansas\Ellis,2530,1854,2408,1854,278742,253440,122,0,1854,1854,0.007315341,1
991,Kentucky\Boone,382,207,382,0,35823,28317,0,0,207,207,0.007310096,0
2995,West Virginia\Jefferson,216,301,216,301,42964,41372,0,0,301,301,0.007275452,1
2664,Texas\Jones,3877,3576,0,2188,334826,301915,0,1388,2188,2188,0.007247073,1
811,Iowa\Floyd,1076,2103,1076,0,274051,291111,0,0,2103,2103,0.007224049,0
595,Illinois\Clinton,1191,1873,1191,1873,246393,259554,0,0,1873,1873,0.007216225,1
1075,Kentucky\Ohio,0,564,0,564,84808,78814,0,0,564,564,0.007156089,1
1774,New Hampshire\Sullivan,77,59,77,59,13398,8302,0,0,59,59,0.007106721,1
1111,Louisiana\Bienville,34,115,0,0,9979,16214,0,0,115,115,0.007092636,0
2294,Pennsylvania\Lycoming,1711,565,1700,0,88011,79664,11,0,565,565,0.007092288,0
2642,Texas\Hays,941,1032,287,215,39265,30315,654,817,215,215,0.007092199,1
3003,West Virginia\Mason,377,280,361,0,40420,39661,16,0,280,280,0.007059832,0
2135,Ohio\Williams,494,1281,494,1281,179095,181570,0,0,1281,1281,0.00705513,1
1432,Mississippi\Kemper,99,126,99,126,26164,17986,0,0,126,126,0.007005449,1
2912,Virginia\Rappahannock,131,121,0,0,20871,17307,0,0,121,121,0.006991391,0
1514,Missouri\Douglas,318,363,0,316,64931,45232,0,47,316,316,0.006986204,1
2179,Oklahoma\Lincoln,2191,757,1104,743,147219,106494,1087,14,743,743,0.006976919,1
2148,Oklahoma\Carter,1276,1128,954,554,96709,79459,322,574,554,554,0.006972149,1
3043,Wisconsin\Columbia,1414,1649,1414,1631,241903,234125,0,18,1631,1631,0.006966364,1
2257,Pennsylvania\Beaver,389,198,376,198,35494,28531,13,0,198,198,0.00693982,1
1838,New York\Chautauqua,1153,894,1055,894,127248,129467,98,0,894,894,0.006905235,1
606,Illinois\Effingham,264,1668,0,1668,204474,241885,0,0,1668,1668,0.006895839,1
2565,Texas\Caldwell,909,633,681,384,71459,55928,228,249,384,384,0.006865971,1
2822,Vermont,2295,3565,2203,3333,516924,488327,92,232,3333,3333,0.006825344,1
1537,Missouri\Lincoln,3089,1300,0,0,167803,191809,0,0,1300,1300,0.006777576,0
1120,Louisiana\De Soto,552,273,532,204,35939,30239,20,69,204,204,0.006746255,1
2682,Texas\Leon,2831,759,2057,499,121142,74011,774,260,499,499,0.006742241,1
2634,Texas\Hamilton,763,619,713,509,97603,75612,50,110,509,509,0.006731736,1
1333,Minnesota\Freeborn,1363,2399,1363,2399,359581,356653,0,0,2399,2399,0.006726426,1
2070,Ohio\Delaware,312,823,312,823,122444,123380,0,0,823,823,0.006670449,1
1858,New York\Madison,513,807,421,738,115935,110970,92,69,738,738,0.006650446,1
930,Kansas\Lincoln,1404,1361,1404,1361,228757,204683,0,0,1361,1361,0.006649306,1
1467,Mississippi\Tippah,246,251,0,251,52810,37857,0,0,251,251,0.006630214,1
3009,West Virginia\Morgan,48,52,0,52,7821,7847,0,0,52,52,0.006626736,1
1949,North Carolina\Lincoln,497,169,472,0,32246,25606,25,0,169,169,0.006600016,0
2853,Virginia\Campbell,780,291,758,291,49891,44109,22,0,291,291,0.006597293,1
1430,Mississippi\Jefferson Davis,121,326,121,70,21687,10631,0,256,70,70,0.006584517,1
1251,Michigan\Gladwin,200,461,200,263,43686,40121,0,198,263,263,0.006555171,1
2065,Ohio\Coshocton,136,581,136,581,91868,88718,0,0,581,581,0.00654884,1
2711,Texas\Nacogdoches,535,343,458,285,59353,43706,77,58,285,285,0.006520844,1
680,Illinois\Will,1912,1456,0,1439,208874,221175,0,17,1439,1439,0.00650616,1
777,Iowa,189518,171656,188765,170542,26316332,26256347,753,1114,170542,170542,0.006495268,1
1182,Maine\Somerset,104,196,86,196,34082,30190,18,0,196,196,0.006492216,1
2876,Virginia\Greene,154,49,38,49,12571,7557,116,0,49,49,0.006484055,1
893,Kansas\Coffey,1334,1174,1334,1174,168644,183403,0,0,1174,1174,0.006401204,1
2474,Tennessee\Hamilton,66,126,66,0,22521,19737,0,0,126,126,0.006383949,0
2833,Vermont\Rutland,267,232,267,0,46305,36465,0,0,232,232,0.006362265,0
879,Kansas\Anderson,2578,1419,0,1419,214928,223964,0,0,1419,1419,0.00633584,1
1030,Kentucky\Hardin,587,744,587,724,121817,114429,0,20,724,724,0.006327067,1
2625,Texas\Goliad,903,744,0,208,58898,32990,0,536,208,208,0.006304941,1
1893,New York\Yates,549,593,496,555,86596,88113,53,38,555,555,0.00629873,1
2442,Tennessee\Anderson,86,64,86,64,17025,10163,0,0,64,64,0.006297353,1
833,Iowa\Lee,1722,1074,1722,1074,174371,172333,0,0,1074,1074,0.00623212,1
2059,Ohio\Carroll,644,363,627,363,62189,58445,17,0,363,363,0.006210968,1
2526,Tennessee\Trousdale,121,86,0,0,19771,13893,0,0,86,86,0.006190168,0
1866,New York\Ontario,1012,917,959,0,153100,148209,53,0,917,917,0.006187209,0
147,Arkansas\Polk,645,371,375,197,44973,31927,270,174,197,197,0.006170326,1
423,Georgia\Elbert,66,84,35,84,19185,13634,31,0,84,84,0.006161068,1
1173,Maine\Franklin,66,59,66,59,12157,9601,0,0,59,59,0.006145193,1
1540,Missouri\McDonald,323,303,315,0,54882,49452,8,0,303,303,0.006127154,0
1078,Kentucky\Owsley,66,42,66,0,9889,6857,0,0,42,42,0.006125128,0
2244,Oregon\Sherman,2810,2235,1370,0,345494,365078,1440,0,2235,2235,0.006121979,0
2116,Ohio\Portage,399,356,347,356,57541,58726,52,0,356,356,0.006062051,1
2831,Vermont\Orange,155,201,155,201,35613,33207,0,0,201,201,0.006052941,1
3068,Wisconsin\Manitowoc,669,1125,0,0,199725,186852,0,0,1125,1125,0.006020808,0
95,Arkansas\Boone,226,354,0,233,57607,38746,0,121,233,233,0.006013524,1
2727,Texas\Rains,590,206,418,206,32704,34258,172,0,206,206,0.006013194,1
2174,Oklahoma\Kay,3569,1844,3388,0,323049,307126,181,0,1844,1844,0.00600405,0
2169,Oklahoma\Haskell,1703,500,1571,280,72284,46650,132,220,280,280,0.006002144,1
849,Iowa\Osceola,2042,1339,0,1339,237564,223260,0,0,1339,1339,0.005997492,1
1601,Montana\Carter,7104,1390,2688,0,267216,234849,4416,0,1390,1390,0.005918697,0
2024,North Dakota\Mercer,2348,1364,1818,1364,238899,230953,530,0,1364,1364,0.005905964,1
455,Georgia\Jones,308,37,0,37,8575,6272,0,0,37,37,0.005899235,1
1889,New York\Washington,467,601,401,601,112016,101904,66,0,601,601,0.005897708,1
1102,Kentucky\Wolfe,42,47,42,47,15614,8000,0,0,47,47,0.005875,1
2691,Texas\McCulloch,890,949,826,525,108473,90112,64,424,525,525,0.005826083,1
2521,Tennessee\Smith,223,217,198,214,49321,36842,25,3,214,214,0.005808588,1
2532,Tennessee\Wayne,166,212,0,212,41334,36716,0,0,212,212,0.005774049,1
1567,Missouri\Ralls,873,1134,0,1134,168430,196923,0,0,1134,1134,0.005758596,1
1517,Missouri\Gasconade,206,367,206,0,81379,63742,0,0,367,367,0.005757585,0
1877,New York\Saratoga,458,252,415,0,42949,43818,43,0,252,252,0.005751061,0
2301,Pennsylvania\Northampton,247,318,0,0,58903,55555,0,0,318,318,0.005724057,0
2435,South Dakota\Tripp,3529,2723,3529,2723,440874,477836,0,0,2723,2723,0.005698608,1
2913,Virginia\Richmond,243,127,243,127,24216,22310,0,0,127,127,0.005692515,1
985,Kentucky\Allen,314,297,0,297,69207,52263,0,0,297,297,0.005682797,1
773,Indiana\Wayne,197,707,197,707,138041,124601,0,0,707,707,0.005674112,1
920,Kansas\Jackson,0,772,0,0,146775,136084,0,0,772,772,0.005672967,0
94,Arkansas\Benton,378,635,378,499,101107,88042,0,136,499,499,0.005667749,1
2007,North Dakota\Divide,2289,2368,2289,0,538343,419216,0,0,2368,2368,0.005648639,0
701,Indiana\DeKalb,761,772,0,0,135150,136807,0,0,772,772,0.005642986,0
2741,Texas\San Jacinto,943,538,893,136,21027,24262,50,402,136,136,0.005605474,1
162,Arkansas\Washington,808,584,0,468,111961,83502,0,116,468,468,0.005604656,1
3078,Wisconsin\Ozaukee,422,288,0,0,57652,51672,0,0,288,288,0.005573618,0
994,Kentucky\Boyle,90,233,90,233,46532,41867,0,0,233,233,0.005565242,1
896,Kansas\Crawford,2596,1065,0,1065,180324,192100,0,0,1065,1065,0.005543988,1
2511,Tennessee\Polk,148,90,0,90,17780,16258,0,0,90,90,0.005535736,1
1882,New York\Steuben,1539,1223,0,0,211164,221713,0,0,1223,1223,0.00551614,0
1839,New York\Chemung,165,155,63,155,32923,28124,102,0,155,155,0.005511307,1
2412,South Dakota\Kingsbury,1809,2100,1779,2100,356912,382259,30,0,2100,2100,0.005493657,1
2430,South Dakota\Shannon,0,534,0,534,104917,97778,0,0,534,534,0.005461351,1
2611,Texas\Fannin,5264,1172,5249,1089,207535,200014,15,83,1089,1089,0.005444619,1
2443,Tennessee\Bedford,326,482,0,0,106886,88563,0,0,482,482,0.005442453,0
1256,Michigan\Houghton,136,59,99,0,11235,10846,37,0,59,59,0.005439793,0
2738,Texas\Rusk,848,373,759,258,67334,47469,89,115,258,258,0.005435126,1
1098,Kentucky\Washington,721,324,0,304,80643,55949,0,20,304,304,0.00543352,1
1942,North Carolina\Hyde,647,451,0,451,67507,83140,0,0,451,451,0.005424585,1
656,Illinois\Pike,1334,1674,0,1674,288091,310211,0,0,1674,1674,0.005396327,1
2894,Virginia\Mathews,53,17,53,17,3171,3153,0,0,17,17,0.00539169,1
1040,Kentucky\Jessamine,137,193,137,180,37716,33566,0,13,180,180,0.005362569,1
2428,South Dakota\Roberts,1311,2301,1311,2301,412361,429272,0,0,2301,2301,0.005360238,1
2404,South Dakota\Hanson,2685,1128,2685,1128,174403,212178,0,0,1128,1128,0.005316291,1
1565,Missouri\Pulaski,0,111,0,0,33625,20949,0,0,111,111,0.005298582,0
1910,North Carolina\Carteret,169,241,157,241,38005,45485,12,0,241,241,0.00529845,1
473,Georgia\Monroe,150,28,0,28,9075,5291,0,0,28,28,0.005292005,1
3017,West Virginia\Raleigh,10,43,10,43,14119,8129,0,0,43,43,0.005289704,1
1047,Kentucky\Lawrence,41,34,41,0,15243,6458,0,0,34,34,0.005264788,0
2423,South Dakota\Minnehaha,2717,1695,0,1695,326402,322386,0,0,1695,1695,0.005257672,1
807,Iowa\Dickinson,841,909,841,909,211532,173603,0,0,909,909,0.005236085,1
554,Idaho\Clearwater,0,183,0,151,32386,28904,0,32,151,151,0.00522419,1
2501,Tennessee\Maury,382,469,382,469,107344,90148,0,0,469,469,0.005202556,1
2463,Tennessee\Dickson,258,240,0,240,55294,46140,0,0,240,240,0.00520156,1
1921,North Carolina\Currituck,489,167,0,167,25117,32144,0,0,167,167,0.005195371,1
1445,Mississippi\Monroe,1709,516,1529,516,84029,99597,180,0,516,516,0.005180879,1
3067,Wisconsin\Lincoln,294,198,0,198,42570,38249,0,0,198,198,0.005176606,1
528,Georgia\Wilkes,390,132,136,102,19328,19715,254,30,102,102,0.005173726,1
439,Georgia\Habersham,293,49,0,49,8361,9564,0,0,49,49,0.005123379,1
56,Alabama\Randolph,217,74,110,74,19914,14445,107,0,74,74,0.00512288,1
2280,Pennsylvania\Forest,0,13,0,13,4400,2549,0,0,13,13,0.005100039,1
1608,Montana\Fallon,1536,877,0,877,247773,172063,0,0,877,877,0.00509697,1
762,Indiana\Switzerland,59,132,53,0,25402,25907,6,0,132,132,0.005095148,0
2393,South Dakota\Deuel,577,1057,577,0,199572,207641,0,0,1057,1057,0.005090517,0
1573,Missouri\St. Clair,208,505,188,0,126637,99306,20,0,505,505,0.005085292,0
18,Alabama\Conecuh,130,102,0,0,22692,20081,0,0,102,102,0.005079428,0
875,Iowa\Worth,630,1109,630,1109,213842,218403,0,0,1109,1109,0.005077769,1
2713,Texas\Newton,104,45,0,0,8083,8902,0,0,45,45,0.005055044,0
1316,Minnesota\Blue Earth,614,1707,0,0,375702,338830,0,0,1707,1707,0.005037925,0
1257,Michigan\Huron,2408,2043,2395,0,396865,405985,13,0,2043,2043,0.005032206,0
2093,Ohio\Lawrence,30,85,30,85,18110,16954,0,0,85,85,0.005013566,1
2125,Ohio\Stark,846,528,846,0,104637,105377,0,0,528,528,0.005010581,0
2829,Vermont\Grand Isle,46,69,46,69,11314,13782,0,0,69,69,0.00500653,1
2201,Oklahoma\Pottawatomie,1403,868,813,435,127444,86949,590,433,435,435,0.005002933,1
2078,Ohio\Greene,1669,620,0,0,142281,124738,0,0,620,620,0.004970418,0
993,Kentucky\Boyd,9,24,9,24,7226,4834,0,0,24,24,0.004964832,1
1485,Missouri\Barry,416,364,0,364,114244,73624,0,0,364,364,0.00494404,1
2121,Ohio\Sandusky,496,821,496,0,167236,166275,0,0,821,821,0.004937603,0
619,Illinois\Iroquois,4072,3133,4072,3133,646947,638205,0,0,3133,3133,0.004909081,1
52,Alabama\Morgan,364,325,290,258,72794,52633,74,67,258,258,0.004901868,1
2758,Texas\Taylor,5087,1095,4694,778,204301,158876,393,317,778,778,0.004896901,1
2908,Virginia\Prince Edward,124,96,124,96,25006,19680,0,0,96,96,0.004878049,1
1076,Kentucky\Oldham,203,169,0,118,29014,24266,0,51,118,118,0.004862771,1
987,Kentucky\Ballard,94,411,94,0,84969,85220,0,0,411,411,0.004822812,0
1042,Kentucky\Kenton,23,73,0,73,21484,15144,0,0,73,73,0.004820391,1
1367,Minnesota\Pine,760,515,735,500,102966,103782,25,15,500,500,0.004817791,1
161,Arkansas\Van Buren,478,256,0,142,33882,29517,0,114,142,142,0.004810787,1
2587,Texas\Coryell,767,420,608,410,120881,85751,159,10,410,410,0.004781285,1
9,Alabama\Chambers,338,73,338,73,14335,15285,0,0,73,73,0.004775924,1
2071,Ohio\Erie,160,353,0,343,75261,71855,0,10,343,343,0.004773502,1
2192,Oklahoma\Okfuskee,1282,733,1051,287,83669,60148,231,446,287,287,0.004771563,1
1056,Kentucky\McCracken,205,277,205,237,58242,49731,0,40,237,237,0.004765639,1
660,Illinois\Randolph,404,1083,404,1083,202344,228029,0,0,1083,1083,0.004749396,1
2045,North Dakota\Walsh,2182,3395,0,3392,713647,714525,0,3,3392,3392,0.00474721,1
389,Georgia\Butts,125,23,125,23,6444,4853,0,0,23,23,0.004739336,1
2014,North Dakota\Grant,1895,2382,1895,2382,510893,503992,0,0,2382,2382,0.004726265,1
1127,Louisiana\Iberia,430,404,0,0,98096,85534,0,0,404,404,0.004723268,0
2034,North Dakota\Richland,4636,3724,0,3724,833222,788492,0,0,3724,3724,0.004722939,1
1886,New York\Tompkins,276,254,270,254,67292,54424,6,0,254,254,0.004667059,1
1435,Mississippi\Lauderdale,36,110,0,68,25758,14589,0,42,68,68,0.004661046,1
1586,Missouri\Taney,0,87,7,0,20997,18792,0,0,87,87,0.00462963,0
2540,Texas\Angelina,467,157,250,100,43253,21687,217,57,100,100,0.004611057,1
1023,Kentucky\Garrard,127,201,127,201,59001,43690,0,0,201,201,0.004600595,1
2019,North Dakota\Logan,2420,1528,2420,0,325952,333286,0,0,1528,1528,0.004584651,0
1393,Minnesota\Wilkin,1635,1945,1635,1945,407566,428789,0,0,1945,1945,0.004536031,1
3099,Wisconsin\Washington,528,485,426,485,104273,107278,102,0,485,485,0.004520964,1
1095,Kentucky\Trimble,78,86,78,86,25875,19025,0,0,86,86,0.004520368,1
2571,Texas\Cass,336,249,0,175,51647,38851,0,74,175,175,0.004504389,1
1557,Missouri\Ozark,184,131,184,131,55341,29102,0,0,131,131,0.004501409,1
1375,Minnesota\Rice,525,896,487,887,205576,197330,38,9,887,887,0.004495008,1
732,Indiana\Madison,1517,860,1517,860,204074,191450,0,0,860,860,0.004492034,1
1084,Kentucky\Robertson,51,57,51,57,21707,12718,0,0,57,57,0.004481837,1
2287,Pennsylvania\Juniata,270,261,0,241,59074,53814,0,20,241,241,0.004478389,1
992,Kentucky\Bourbon,175,367,0,335,86523,74806,0,32,335,335,0.00447825,1
1061,Kentucky\Marion,361,314,361,0,78753,70227,0,0,314,314,0.004471215,0
2027,North Dakota\Nelson,0,2121,0,0,457074,474902,0,0,2121,2121,0.004466185,0
2074,Ohio\Franklin,831,255,814,239,50618,53536,17,16,239,239,0.004464286,1
2260,Pennsylvania\Blair,153,282,153,0,61938,63273,0,0,282,282,0.004456877,0
1549,Missouri\Monroe,1473,1060,0,1060,183346,237921,0,0,1060,1060,0.00445526,1
837,Iowa\Lyon,1005,1488,1005,1488,290911,334006,0,0,1488,1488,0.00445501,1
1022,Kentucky\Gallatin,129,48,129,48,15556,10794,0,0,48,48,0.004446915,1
1847,New York\Essex,179,89,0,0,22206,20024,0,0,89,89,0.004444666,0
2139,Oklahoma\Adair,672,197,0,0,66828,44464,0,0,197,197,0.004430551,0
2318,Pennsylvania\Westmoreland,356,426,0,362,107297,81877,0,64,362,362,0.004421266,1
2418,South Dakota\McPherson,476,1266,476,1266,250292,286779,0,0,1266,1266,0.004414549,1
1899,North Carolina\Ashe,254,170,169,146,38039,33134,85,24,146,146,0.00440635,1
1008,Kentucky\Clark,145,222,145,222,68958,50458,0,0,222,222,0.004399699,1
2502,Tennessee\Meigs,174,88,143,88,21331,20041,31,0,88,88,0.004390998,1
2471,Tennessee\Greene,384,403,0,397,118582,90806,0,6,397,397,0.004371958,1
4,Alabama\Bibb,164,55,164,55,8619,12608,0,0,55,55,0.00436231,1
1438,Mississippi\Lee,615,367,0,367,82109,84678,0,0,367,367,0.004334066,1
690,Indiana\Boone,998,910,0,0,210483,210331,0,0,910,910,0.004326514,0
2154,Oklahoma\Comanche,1449,715,0,593,160736,137092,0,122,593,593,0.004325562,1
1301,Michigan\Sanilac,2031,1752,1927,0,368243,405497,104,0,1752,1752,0.004320624,0
1349,Minnesota\Le Sueur,1276,893,1249,893,211006,207466,27,0,893,893,0.00430432,1
257,Colorado\Kiowa,3266,3060,0,0,616758,713345,0,0,3060,3060,0.004289649,0
2049,Ohio,37959,46569,37050,45826,10832772,10748553,909,743,45826,45826,0.004263458,1
1326,Minnesota\Cottonwood,1101,1434,1041,0,351465,336445,60,0,1434,1434,0.004262212,0
2320,Pennsylvania\York,1044,829,1031,0,225389,194977,13,0,829,829,0.004251784,0
2187,Oklahoma\Mayes,791,359,0,0,117269,85194,0,0,359,359,0.004213912,0
2478,Tennessee\Hawkins,188,197,157,178,56334,42284,31,19,178,178,0.00420963,1
2783,Texas\Williamson,964,1281,574,890,229661,211581,390,391,890,890,0.004206427,1
1303,Michigan\Shiawassee,1553,821,0,821,195464,195229,0,0,821,821,0.004205318,1
2990,West Virginia\Hampshire,29,146,29,146,33525,34793,0,0,146,146,0.004196246,1
1584,Missouri\Stone,74,134,74,134,36790,32121,0,0,134,134,0.004171726,1
158,Arkansas\Sharp,283,135,0,120,36673,28776,0,15,120,120,0.004170142,1
1849,New York\Fulton,64,61,0,61,18277,14665,0,0,61,61,0.004159564,1
852,Iowa\Plymouth,2801,1991,2801,0,460619,479844,0,0,1991,1991,0.004149265,0
2928,Virginia\Washington,410,224,255,0,64205,54154,155,0,224,224,0.004136352,0
586,Illinois\Brown,0,353,0,353,92148,85466,0,0,353,353,0.004130297,1
1880,New York\Schuyler,250,157,0,157,37086,38031,0,0,157,157,0.004128211,1
2948,Washington\Garfield,474,795,379,771,174571,187523,95,24,771,771,0.004111496,1
1083,Kentucky\Pulaski,206,370,206,0,104999,90071,0,0,370,370,0.00410787,0
120,Arkansas\Hot Spring,444,79,444,79,25407,19252,0,0,79,79,0.00410347,1
2447,Tennessee\Bradley,108,131,0,117,40542,28570,0,14,117,117,0.004095205,1
2300,Pennsylvania\Montour,84,121,84,121,34321,29564,0,0,121,121,0.004092816,1
2974,Washington\Whitman,6866,4293,4191,4158,1057584,1019951,2675,135,4158,4158,0.004076666,1
2868,Virginia\Floyd,108,192,0,168,45010,41527,0,24,168,168,0.004045561,1
2198,Oklahoma\Payne,898,425,716,0,117667,105142,182,0,425,425,0.004042153,0
3005,West Virginia\Mineral,229,67,229,67,19640,16698,0,0,67,67,0.004012457,1
1015,Kentucky\Elliott,0,82,0,54,19273,13510,0,28,54,54,0.003997039,1
2157,Oklahoma\Creek,319,418,277,284,101997,71117,42,134,284,284,0.003993419,1
50,Alabama\Monroe,807,215,0,0,45873,53898,0,0,215,215,0.003989016,0
1612,Montana\Garfield,4154,1536,3582,0,409816,386104,572,0,1536,1536,0.003978203,0
2646,Texas\Hill,1189,920,400,0,253919,231885,789,0,920,920,0.003967484,0
1002,Kentucky\Campbell,152,59,152,0,20158,14974,0,0,59,59,0.003940163,0
2140,Oklahoma\Alfalfa,2617,1279,2180,0,358592,326634,437,0,1279,1279,0.003915698,0
1507,Missouri\Cooper,393,743,0,0,189065,190348,0,0,743,743,0.003903377,0
2001,North Dakota\Bowman,920,1453,920,1453,371877,372577,0,0,1453,1453,0.003899865,1
719,Indiana\Huntington,315,672,0,672,184951,172569,0,0,672,672,0.003894095,1
1881,New York\Seneca,244,379,244,379,102896,98029,0,0,379,379,0.003866203,1
2541,Texas\Aransas,14,10,0,0,0,2590,0,0,10,10,0.003861004,0
2303,Pennsylvania\Perry,123,312,123,312,92254,81253,0,0,312,312,0.003839858,1
2495,Tennessee\McMinn,260,201,260,185,56371,48187,0,16,185,185,0.00383921,1
738,Indiana\Montgomery,1597,1013,1597,1013,271147,264631,0,0,1013,1013,0.003827972,1
2177,Oklahoma\Latimer,439,146,255,0,42115,38209,184,0,146,146,0.003821089,0
1520,Missouri\Grundy,322,533,0,533,156231,139825,0,0,533,533,0.003811908,1
655,Illinois\Piatt,461,953,455,953,259548,251404,6,0,953,953,0.003790711,1
2938,Washington\Asotin,307,482,151,319,80438,84330,156,163,319,319,0.003782758,1
2136,Ohio\Wood,517,954,0,954,259716,252201,0,0,954,954,0.003782697,1
1884,New York\Sullivan,75,86,0,0,24614,22794,0,0,86,86,0.003772923,0
2712,Texas\Navarro,1117,904,432,551,164245,146074,685,353,551,551,0.003772061,1
2905,Virginia\Patrick,432,108,391,86,25435,22856,41,22,86,86,0.003762688,1
880,Kansas\Atchison,0,543,0,543,172361,144421,0,0,543,543,0.003759841,1
843,Iowa\Mitchell,1296,1025,1296,0,270836,272780,0,0,1025,1025,0.003757607,0
737,Indiana\Monroe,76,103,0,103,27096,27593,0,0,103,103,0.003732831,1
1835,New York\Broome,150,149,150,142,43575,38075,0,7,142,142,0.003729481,1
2978,West Virginia\Berkeley,193,124,0,124,38320,33270,0,0,124,124,0.003727081,1
2044,North Dakota\Traill,0,1957,0,1957,530327,526183,0,0,1957,1957,0.003719238,1
2494,Tennessee\Loudon,206,123,0,0,39310,33149,0,0,123,123,0.003710519,0
1991,North Carolina\Wilkes,303,134,0,134,37263,36152,0,0,134,134,0.003706572,1
25,Alabama\DeKalb,977,267,681,0,91656,72278,296,0,267,267,0.00369407,0
571,Idaho\Nez Perce,560,778,384,668,203591,181393,176,110,668,668,0.003682612,1
93,Arkansas\Baxter,0,84,0,47,18835,12763,0,37,47,47,0.00368252,1
2736,Texas\Rockwall,72,63,46,52,14475,14124,26,11,52,52,0.003681677,1
2319,Pennsylvania\Wyoming,133,119,133,119,41425,32431,0,0,119,119,0.003669329,1
2843,Virginia\Appomattox,43,105,43,0,26931,28654,0,0,105,105,0.00366441,0
2750,Texas\Somervell,473,59,465,45,20043,12296,8,14,45,45,0.003659727,1
1416,Mississippi\Franklin,0,32,4,0,9954,8751,0,0,32,32,0.003656725,0
1528,Missouri\Jackson,304,338,283,274,102769,75134,21,64,274,274,0.003646818,1
1004,Kentucky\Carroll,103,79,0,79,25723,21674,0,0,79,79,0.00364492,1
818,Iowa\Hancock,1046,1231,1046,1231,345604,338379,0,0,1231,1231,0.003637933,1
1924,North Carolina\Davie,306,109,278,0,31192,29967,28,0,109,109,0.003637334,0
1099,Kentucky\Wayne,51,148,51,0,48546,40821,0,0,148,148,0.003625585,0
943,Kansas\Nemaha,281,939,0,939,287855,259025,0,0,939,939,0.003625133,1
888,Kansas\Cherokee,144,820,144,0,235277,226441,0,0,820,820,0.003621252,0
2405,South Dakota\Harding,976,650,0,650,207638,179675,0,0,650,650,0.003617643,1
2923,Virginia\Stafford,221,24,216,0,10551,6636,5,0,24,24,0.003616637,0
2134,Ohio\Wayne,668,758,0,0,192909,209627,0,0,758,758,0.003615946,0
2409,South Dakota\Jackson,1276,630,0,630,228994,176567,0,0,630,630,0.003568051,1
2130,Ohio\Van Wert,0,766,0,766,235927,214763,0,0,766,766,0.003566722,1
48,Alabama\Marshall,1237,166,1177,0,61494,46730,60,0,166,166,0.003552322,0
2867,Virginia\Fauquier,921,395,723,292,85075,82203,198,103,292,292,0.003552182,1
1227,Michigan\Alger,0,31,0,31,10352,8736,0,0,31,31,0.003548535,1
2315,Pennsylvania\Warren,128,98,0,98,43543,27624,0,0,98,98,0.00354764,1
478,Georgia\Newton,214,54,180,31,9910,8786,34,23,31,31,0.003528341,1
2832,Vermont\Orleans,69,185,0,0,55211,52531,0,0,185,185,0.00352173,0
3054,Wisconsin\Grant,488,1272,488,0,354606,361323,0,0,1272,1272,0.003520396,0
1100,Kentucky\Webster,0,379,0,0,107532,107882,0,0,379,379,0.003513098,0
561,Idaho\Idaho,1188,5011,328,736,218804,209805,860,4275,736,736,0.003508019,1
3026,West Virginia\Wayne,9,13,9,0,7165,3723,0,0,13,13,0.003491808,0
3062,Wisconsin\Kenosha,249,237,249,237,71697,68098,0,0,237,237,0.003480278,1
1917,North Carolina\Cleveland,551,164,515,164,52639,47173,36,0,164,164,0.003476565,1
2740,Texas\San Augustine,114,31,114,0,12837,8922,0,0,31,31,0.003474557,0
2871,Virginia\Frederick,299,150,282,138,37900,39746,17,12,138,138,0.003472048,1
3037,Wisconsin\Brown,498,525,0,525,160561,151332,0,0,525,525,0.003469194,1
1052,Kentucky\Lincoln,198,251,186,0,83939,72576,12,0,251,251,0.003458444,0
1454,Mississippi\Pike,225,110,103,50,25670,14554,122,60,50,50,0.003435482,1
515,Georgia\Union,42,21,0,21,6110,6119,0,0,21,21,0.003431933,1
3103,Wisconsin\Winnebago,301,445,0,431,133342,126153,0,14,431,431,0.003416486,1
3039,Wisconsin\Burnett,248,151,248,151,48507,44395,0,0,151,151,0.003401284,1
848,Iowa\O'Brien,0,933,0,933,317535,276479,0,0,933,933,0.003374578,1
376,Georgia\Baldwin,145,15,82,15,8714,4453,63,0,15,15,0.003368516,1
2873,Virginia\Gloucester,58,46,43,46,16393,13673,15,0,46,46,0.003364295,1
2068,Ohio\Darke,353,1064,333,1039,319890,311595,20,25,1039,1039,0.003334457,1
1347,Minnesota\Lake,0,5,0,5,1169,1508,0,0,5,5,0.00331565,1
2902,Virginia\Nottoway,385,75,385,75,24877,22626,0,0,75,75,0.003314771,1
141,Arkansas\Newton,136,57,0,0,24516,17244,0,0,57,57,0.003305498,0
1989,North Carolina\Watauga,86,48,83,48,11735,14524,3,0,48,48,0.003304875,1
481,Georgia\Paulding,10,8,6,8,3544,2425,4,0,8,8,0.003298969,1
1074,Kentucky\Nicholas,130,135,130,135,55462,40923,0,0,135,135,0.003298878,1
510,Georgia\Towns,0,7,0,7,2344,2137,0,0,7,7,0.00327562,1
2915,Virginia\Rockbridge,110,137,110,0,40497,42081,0,0,137,137,0.003255626,0
39,Alabama\Lauderdale,1074,355,928,325,108239,99952,146,30,325,325,0.003251561,1
3036,Wisconsin\Bayfield,204,118,0,118,47594,36296,0,0,118,118,0.003251047,1
2064,Ohio\Columbiana,337,263,209,0,87153,81687,128,0,263,263,0.003219607,0
2497,Tennessee\Macon,78,153,78,153,55364,47627,0,0,153,153,0.003212464,1
2165,Oklahoma\Grant,1473,1314,0,1314,455116,409194,0,0,1314,1314,0.003211191,1
2184,Oklahoma\McIntosh,572,186,381,0,70597,58096,191,0,186,186,0.003201597,0
2305,Pennsylvania\Pike,12,11,0,11,2908,3436,0,0,11,11,0.003201397,1
652,Illinois\Ogle,1248,1075,1248,0,333550,335850,0,0,1075,1075,0.003200834,0
36,Alabama\Jackson,713,437,395,286,112500,89364,318,151,286,286,0.003200394,1
1165,Louisiana\West Baton Rouge,0,82,0,0,19923,25632,0,0,82,82,0.003199126,0
635,Illinois\Logan,1345,1095,1345,0,303129,343001,0,0,1095,1095,0.003192411,0
2411,South Dakota\Jones,680,670,680,670,190525,210080,0,0,670,670,0.003189261,1
941,Kansas\Morris,342,489,342,489,154426,153927,0,0,489,489,0.003176831,1
904,Kansas\Ellsworth,607,574,607,574,180278,182724,0,0,574,574,0.00314135,1
1059,Kentucky\Madison,374,229,374,229,108596,72977,0,0,229,229,0.003137975,1
498,Georgia\Stephens,29,15,0,15,4192,4782,0,0,15,15,0.003136763,1
2270,Pennsylvania\Clearfield,52,109,40,109,32459,34781,12,0,109,109,0.003133895,1
3080,Wisconsin\Pierce,280,521,275,521,177989,166276,5,0,521,521,0.003133345,1
2930,Virginia\Wise,115,11,0,11,3835,3514,0,0,11,11,0.003130336,1
1553,Missouri\Newton,1150,292,381,292,107943,93370,769,0,292,292,0.003127343,1
2684,Texas\Limestone,759,330,753,252,141852,80867,6,78,252,252,0.003116228,1
682,Illinois\Winnebago,370,495,0,495,162619,159634,0,0,495,495,0.003100843,1
996,Kentucky\Breathitt,12,15,12,15,9394,4843,0,0,15,15,0.003097254,1
2986,West Virginia\Fayette,0,19,0,19,7891,6139,0,0,19,19,0.003094967,1
1400,Mississippi\Amite,206,71,0,0,27418,22973,0,0,71,71,0.003090585,0
2277,Pennsylvania\Elk,21,30,21,30,13652,9727,0,0,30,30,0.003084199,1
854,Iowa\Polk,720,543,0,543,232636,178551,0,0,543,543,0.003041148,1
1575,Missouri\St. Francois,275,97,275,0,44476,32033,0,0,97,97,0.003028127,0
1057,Kentucky\McCreary,103,10,103,0,5082,3304,0,0,10,10,0.003026634,0
929,Kansas\Leavenworth,701,310,599,0,102544,102477,102,0,310,310,0.003025069,0
859,Iowa\Scott,1993,607,0,607,230695,201361,0,0,607,607,0.003014486,1
699,Indiana\Dearborn,117,97,0,80,35833,26763,0,17,80,80,0.002989202,1
28,Alabama\Etowah,589,70,559,58,29605,19480,30,12,58,58,0.002977413,1
1383,Minnesota\Steele,512,644,0,644,242129,217923,0,0,644,644,0.002955172,1
1252,Michigan\Gogebic,0,7,0,7,1744,2369,0,0,7,7,0.002954833,1
2678,Texas\Lampasas,437,166,278,148,70636,50255,159,18,148,148,0.002944981,1
2058,Ohio\Butler,214,342,161,342,96442,116351,53,0,342,342,0.002939382,1
927,Kansas\Labette,0,567,0,567,193385,196661,0,0,567,567,0.002883134,1
2114,Ohio\Pickaway,771,766,0,766,257059,265843,0,0,766,766,0.0028814,1
1268,Michigan\Lake,56,33,56,0,10544,11460,0,0,33,33,0.002879581,0
1574,Missouri\Ste. Genevieve,365,208,365,208,86003,72266,0,0,208,208,0.002878255,1
2536,Tennessee\Wilson,108,183,95,164,69093,57164,13,19,164,164,0.002868938,1
3027,West Virginia\Webster,7,5,7,5,2768,1755,0,0,5,5,0.002849003,1
1519,Missouri\Greene,123,316,123,194,105551,68216,0,122,194,194,0.002843908,1
3095,Wisconsin\Vernon,156,512,156,0,187932,181510,0,0,512,512,0.002820781,0
2050,Ohio\Adams,84,238,0,0,95690,84394,0,0,238,238,0.002820106,0
1984,North Carolina\Union,331,427,0,416,121067,148278,0,11,416,416,0.002805541,1
1510,Missouri\Dallas,211,230,0,168,84250,60120,0,62,168,168,0.002794411,1
65,Alabama\Washington,95,35,71,35,18971,12634,24,0,35,35,0.002770302,1
2317,Pennsylvania\Wayne,118,143,98,119,42403,43153,20,24,119,119,0.00275763,1
2579,Texas\Coleman,1173,1022,729,372,188432,135473,444,650,372,372,0.002745935,1
1594,Missouri\Wright,854,184,170,0,91225,67169,684,0,184,184,0.002739359,0
786,Iowa\Bremer,290,664,290,0,222988,242541,0,0,664,664,0.002737681,0
2922,Virginia\Spotsylvania,144,58,84,51,23773,18715,60,7,51,51,0.002725087,1
2499,Tennessee\Marion,85,60,85,60,24749,22028,0,0,60,60,0.002723806,1
2089,Ohio\Jackson,4,74,4,0,33790,27184,0,0,74,74,0.00272219,0
2998,West Virginia\Lincoln,3,9,3,9,6722,3308,0,0,9,9,0.002720677,1
13,Alabama\Clarke,62,21,62,0,10570,7738,0,0,21,21,0.00271388,0
883,Kansas\Bourbon,0,343,0,343,139863,126446,0,0,343,343,0.00271262,1
2872,Virginia\Giles,30,33,30,33,16022,12186,0,0,33,33,0.002708026,1
999,Kentucky\Butler,0,169,0,169,73581,62776,0,0,169,169,0.002692112,1
1551,Missouri\Morgan,430,215,404,207,93491,77619,26,8,207,207,0.002666873,1
2273,Pennsylvania\Crawford,564,347,0,347,139526,130284,0,0,347,347,0.002663412,1
2075,Ohio\Fulton,359,491,0,476,171973,179634,0,15,476,476,0.002649832,1
2290,Pennsylvania\Lawrence,107,124,0,124,61521,46839,0,0,124,124,0.002647367,1
1592,Missouri\Webster,219,219,200,0,99071,82900,19,0,219,219,0.002641737,0
1876,New York\St. Lawrence,257,557,194,454,176921,172116,63,103,454,454,0.002637756,1
1160,Louisiana\Union,27,44,7,0,18631,16835,20,0,44,44,0.002613603,0
2110,Ohio\Noble,11,139,11,75,30284,28794,0,64,75,75,0.002604709,1
1477,Mississippi\Winston,185,49,0,0,22391,18831,0,0,49,49,0.002602092,0
608,Illinois\Ford,55,771,55,771,258674,298030,0,0,771,771,0.002586988,1
1068,Kentucky\Metcalfe,84,128,84,0,69253,49686,0,0,128,128,0.002576178,0
1162,Louisiana\Vernon,7,23,7,23,11797,8939,0,0,23,23,0.002572995,1
1357,Minnesota\Mille Lacs,392,203,382,203,76512,78935,10,0,203,203,0.002571736,1
1019,Kentucky\Floyd,237,3,237,3,2002,1168,0,0,3,3,0.002568493,1
1844,New York\Delaware,65,158,65,152,68959,59331,0,6,152,152,0.002561899,1
1082,Kentucky\Powell,11,19,11,0,13522,7479,0,0,19,19,0.002540447,0
754,Indiana\Rush,503,478,486,0,201582,188691,17,0,478,478,0.002533242,0
2084,Ohio\Henry,614,559,614,559,218797,221399,0,0,559,559,0.002524853,1
2823,Vermont\Addison,388,320,388,0,116067,126818,0,0,320,320,0.002523301,0
1543,Missouri\Maries,49,193,49,149,70335,59437,0,44,149,149,0.002506856,1
2976,West Virginia,2189,2064,0,2008,942132,804006,0,56,2008,2008,0.002497494,1
827,Iowa\Jasper,577,810,577,810,378768,324792,0,0,810,810,0.002493904,1
2586,Texas\Cooke,548,359,435,330,136571,132431,113,29,330,330,0.002491864,1
1768,New Hampshire\Coos,23,31,23,31,13945,12460,0,0,31,31,0.002487961,1
1072,Kentucky\Muhlenberg,74,167,0,0,74483,67127,0,0,167,167,0.002487822,0
1428,Mississippi\Jasper,36,35,36,35,21098,14095,0,0,35,35,0.00248315,1
1033,Kentucky\Hart,103,188,103,0,82651,76126,0,0,188,188,0.00246959,0
2459,Tennessee\Cumberland,371,126,0,122,54320,49479,0,4,122,122,0.002465693,1
1840,New York\Chenango,141,195,0,195,86719,79255,0,0,195,195,0.002460413,1
160,Arkansas\Union,53,19,53,19,11610,7750,0,0,19,19,0.002451613,1
638,Illinois\McLean,2935,1595,2935,1595,647350,653874,0,0,1595,1595,0.002439308,1
2514,Tennessee\Roane,42,34,0,0,18795,13981,0,0,34,34,0.002431872,0
801,Iowa\Crawford,0,982,0,982,384715,404713,0,0,982,982,0.002426411,1
1870,New York\Otsego,243,206,224,0,88174,85498,19,0,206,206,0.002409413,0
1459,Mississippi\Scott,56,67,0,67,34403,27825,0,0,67,67,0.002407907,1
1090,Kentucky\Simpson,126,188,126,0,89097,78545,0,0,188,188,0.002393532,0
2982,West Virginia\Cabell,20,15,20,15,9235,6278,0,0,15,15,0.002389296,1
2313,Pennsylvania\Union,187,125,0,0,50201,52661,0,0,125,125,0.002373673,0
2256,Pennsylvania\Armstrong,200,158,200,0,69360,66565,0,0,158,158,0.00237362,0
1860,New York\Montgomery,184,203,184,203,84091,85898,0,0,203,203,0.002363268,1
2487,Tennessee\Johnson,18,38,18,38,18056,16138,0,0,38,38,0.002354691,1
1037,Kentucky\Hopkins,138,221,138,221,101796,94245,0,0,221,221,0.002344952,1
692,Indiana\Carroll,353,443,0,0,178177,189494,0,0,443,443,0.002337805,0
2503,Tennessee\Monroe,35,112,28,0,43646,48108,7,0,112,112,0.002328095,0
3046,Wisconsin\Dodge,644,772,0,0,342864,332609,0,0,772,772,0.002321044,0
3048,Wisconsin\Douglas,87,67,51,0,29793,29093,36,0,67,67,0.002302959,0
1299,Michigan\St. Clair,1310,360,1237,349,135377,151643,73,11,349,349,0.002301458,1
1005,Kentucky\Carter,36,52,36,0,38997,22629,0,0,52,52,0.002297936,0
1187,Maryland\Allegany,319,27,0,27,12479,11817,0,0,27,27,0.002284844,1
3001,West Virginia\Marion,9,29,0,29,15971,12702,0,0,29,29,0.002283105,1
2825,Vermont\Caledonia,43,126,43,66,30776,29050,0,60,66,66,0.002271945,1
1837,New York\Cayuga,241,412,0,0,193034,181736,0,0,412,412,0.002267025,0
2988,West Virginia\Grant,84,48,0,48,20640,21321,0,0,48,48,0.002251302,1
663,Illinois\St. Clair,1075,512,1043,0,284759,227432,32,0,512,512,0.002251222,0
1018,Kentucky\Fleming,38,163,38,163,79539,73112,0,0,163,163,0.002229456,1
1548,Missouri\Moniteau,160,221,0,221,122630,99864,0,0,221,221,0.00221301,1
1048,Kentucky\Lee,25,12,0,12,9246,5435,0,0,12,12,0.002207912,1
2030,North Dakota\Pierce,0,1048,0,1048,452064,479840,0,0,1048,1048,0.002184061,1
1168,Louisiana\Winn,52,9,0,9,6622,4123,0,0,9,9,0.002182877,1
2053,Ohio\Ashtabula,352,237,0,0,106255,109025,0,0,237,237,0.002173813,0
1539,Missouri\Livingston,0,435,0,0,221076,200540,0,0,435,435,0.002169143,0
2196,Oklahoma\Ottawa,287,232,0,190,108086,87881,0,42,190,190,0.002162015,1
1442,Mississippi\Madison,2592,148,0,0,81775,68648,0,0,148,148,0.002155926,0
2524,Tennessee\Sumner,284,162,266,147,89492,68684,18,15,147,147,0.002140236,1
1097,Kentucky\Warren,338,421,338,312,147878,146183,0,109,312,312,0.002134311,1
47,Alabama\Marion,315,46,0,46,30268,21799,0,0,46,46,0.002110189,1
2400,South Dakota\Gregory,1658,504,1658,504,256276,239087,0,0,504,504,0.002108019,1
3077,Wisconsin\Outagamie,234,439,234,439,207537,210085,0,0,439,439,0.00208963,1
665,Illinois\Sangamon,829,984,0,0,485192,475849,0,0,984,984,0.002067883,0
809,Iowa\Emmet,250,412,250,412,233934,201900,0,0,412,412,0.002040614,1
1046,Kentucky\Laurel,46,71,46,71,43205,35031,0,0,71,71,0.002026776,1
142,Arkansas\Ouachita,22,14,22,14,10578,6925,0,0,14,14,0.002021661,1
1997,North Dakota\Barnes,1767,1691,1767,1691,795039,836450,0,0,1691,1691,0.002021639,1
2191,Oklahoma\Nowata,131,131,47,131,76333,64821,84,0,131,131,0.00202095,1
616,Illinois\Hardin,0,34,0,0,16366,16839,0,0,34,34,0.002019122,0
2889,Virginia\Lee,297,61,297,0,37738,30353,0,0,61,61,0.002009686,0
1355,Minnesota\Martin,1026,815,1026,0,426660,405588,0,0,815,815,0.002009428,0
2122,Ohio\Scioto,45,84,45,0,52334,41989,0,0,84,84,0.002000524,0
788,Iowa\Buena Vista,3,668,3,668,335772,333950,0,0,668,668,0.002000299,1
2082,Ohio\Hardin,0,446,0,443,230547,222562,0,3,443,443,0.001990457,1
2849,Virginia\Botetourt,63,52,63,0,27662,26190,0,0,52,52,0.001985491,0
2020,North Dakota\McHenry,8650,1235,8650,1235,692133,624781,0,0,1235,1235,0.001976693,1
1841,New York\Clinton,218,146,114,146,70891,74012,104,0,146,146,0.001972653,1
622,Illinois\Jefferson,33,339,33,0,185983,172485,0,0,339,339,0.001965388,0
2118,Ohio\Putnam,483,561,0,561,283594,287239,0,0,561,561,0.001953077,1
2072,Ohio\Fairfield,255,341,227,318,140666,162932,28,23,318,318,0.001951734,1
2451,Tennessee\Carter,92,24,92,0,18252,12381,0,0,24,24,0.001938454,0
2396,South Dakota\Edmunds,1060,955,1060,955,454285,492795,0,0,955,955,0.001937926,1
961,Kansas\Russell,244,452,244,0,225950,234870,0,0,452,452,0.001924469,0
2461,Tennessee\Decatur,351,48,0,0,33091,25021,0,0,48,48,0.001918389,0
2297,Pennsylvania\Mifflin,138,116,138,102,58758,53241,0,14,102,102,0.001915817,1
988,Kentucky\Barren,197,249,197,0,151246,130004,0,0,249,249,0.001915326,0
1998,North Dakota\Benson,3802,1232,3802,1232,603869,644352,0,0,1232,1232,0.001911998,1
2127,Ohio\Trumbull,152,148,0,0,87440,77462,0,0,148,148,0.001910614,0
3044,Wisconsin\Crawford,110,192,0,188,105353,98432,0,4,188,188,0.001909948,1
2523,Tennessee\Sullivan,98,60,86,0,36826,31695,12,0,60,60,0.001893043,0
2052,Ohio\Ashland,72,228,0,210,109312,110937,0,18,210,210,0.001892966,1
2846,Virginia\Bath,7,19,7,19,11818,10048,0,0,19,19,0.001890924,1
853,Iowa\Pocahontas,0,600,0,0,348121,317484,0,0,600,600,0.001889859,0
1290,Michigan\Ogemaw,239,76,0,0,40490,40218,0,0,76,76,0.001889701,0
98,Arkansas\Carroll,474,105,0,91,64830,48168,0,14,91,91,0.001889221,1
2449,Tennessee\Cannon,116,72,116,0,48624,38470,0,0,72,72,0.001871588,0
1471,Mississippi\Walthall,117,60,57,0,38694,32171,60,0,60,60,0.001865034,0
2508,Tennessee\Overton,157,67,0,67,49748,36114,0,0,67,67,0.001855236,1
1854,New York\Jefferson,282,321,211,0,166233,173519,71,0,321,321,0.001849942,0
676,Illinois\Washington,0,601,0,601,324924,325688,0,0,601,601,0.001845324,1
2087,Ohio\Holmes,217,273,0,229,103699,124136,0,44,229,229,0.001844751,1
2062,Ohio\Clermont,90,173,87,163,75839,88523,3,10,163,163,0.001841329,1
1581,Missouri\Shannon,70,42,70,0,28126,22952,0,0,42,42,0.001829906,0
64,Alabama\Walker,454,24,408,24,20886,13131,46,0,24,24,0.001827736,1
2054,Ohio\Athens,41,57,36,51,26217,28044,5,6,51,51,0.001818571,1
2534,Tennessee\White,63,71,63,71,56816,39583,0,0,71,71,0.001793699,1
2076,Ohio\Gallia,94,162,94,62,38060,34606,0,100,62,62,0.001791597,1
1128,Louisiana\Iberville,0,1012,17,112,67045,62997,0,900,112,112,0.001777862,1
1379,Minnesota\Scott,446,198,429,0,94786,111627,17,0,198,198,0.001773764,0
1570,Missouri\Reynolds,9,29,9,0,24933,16469,0,0,29,29,0.001760884,0
914,Kansas\Greenwood,356,183,356,183,108469,103994,0,0,183,183,0.001759717,1
1462,Mississippi\Smith,404,126,289,46,25148,26166,115,80,46,46,0.001758007,1
2519,Tennessee\Sevier,76,30,0,30,22253,17112,0,0,30,30,0.001753156,1
1363,Minnesota\Norman,571,863,571,863,465225,492474,0,0,863,863,0.001752377,1
1864,New York\Oneida,320,208,0,208,108946,118728,0,0,208,208,0.001751904,1
1045,Kentucky\Larue,169,117,169,117,71976,66947,0,0,117,117,0.001747651,1
2882,Virginia\Highland,0,20,0,20,12612,11608,0,0,20,20,0.00172295,1
2893,Virginia\Madison,69,69,55,69,42011,40054,14,0,69,69,0.001722674,1
1458,Mississippi\Rankin,360,49,60,0,40574,28524,300,0,49,49,0.001717852,0
565,Idaho\Latah,310,451,54,434,242862,254166,256,17,434,434,0.001707545,1
1071,Kentucky\Morgan,120,41,120,0,41255,24027,0,0,41,41,0.001706414,0
846,Iowa\Montgomery,0,353,0,353,176108,207448,0,0,353,353,0.001701631,1
1006,Kentucky\Casey,190,103,190,103,77866,60559,0,0,103,103,0.001700821,1
3042,Wisconsin\Clark,234,585,234,528,291609,310919,0,57,528,528,0.001698191,1
1533,Missouri\Laclede,128,203,27,151,94172,89550,101,52,151,151,0.001686209,1
1437,Mississippi\Leake,295,104,149,38,30628,22582,146,66,38,38,0.001682756,1
1092,Kentucky\Taylor,165,100,165,0,59612,59479,0,0,100,100,0.001681266,0
2977,West Virginia\Barbour,16,32,16,32,23073,19206,0,0,32,32,0.001666146,1
2542,Texas\Archer,967,191,890,0,110386,115641,77,0,191,191,0.001651663,0
1232,Michigan\Baraga,15,13,15,13,9246,7875,0,0,13,13,0.001650794,1
2918,Virginia\Scott,243,55,214,0,41935,33436,29,0,55,55,0.001644934,0
858,Iowa\Sac,723,547,723,547,337872,332957,0,0,547,547,0.001642855,1
1319,Minnesota\Carver,483,216,323,216,144542,131550,160,0,216,216,0.001641961,1
683,Illinois\Woodford,840,477,0,0,267323,291630,0,0,477,477,0.001635634,0
686,Indiana\Allen,726,395,689,0,230416,241522,37,0,395,395,0.001635462,0
1062,Kentucky\Marshall,85,111,0,89,55979,54795,0,22,89,89,0.001624236,1
2040,North Dakota\Stark,1009,809,1005,0,529062,498785,4,0,809,809,0.001621941,0
1541,Missouri\Macon,111,345,0,345,219559,214707,0,0,345,345,0.001606841,1
2607,Texas\Ellis,825,411,667,359,204578,224446,158,52,359,359,0.001599494,1
1857,New York\Livingston,499,239,499,0,165843,149591,0,0,239,239,0.00159769,0
2847,Virginia\Bedford,567,94,521,0,68918,59122,46,0,94,94,0.001589933,0
2874,Virginia\Goochland,21,31,21,31,22821,19499,0,0,31,31,0.001589825,1
2875,Virginia\Grayson,97,44,27,0,40319,27879,70,0,44,44,0.001578249,0
1024,Kentucky\Grant,250,52,250,52,52590,32984,0,0,52,52,0.001576522,1
744,Indiana\Owen,64,98,64,0,53510,62472,0,0,98,98,0.001568703,0
1069,Kentucky\Monroe,119,97,119,97,73202,61978,0,0,97,97,0.001565071,1
2095,Ohio\Logan,43,278,43,278,168822,177746,0,0,278,278,0.00156403,1
1350,Minnesota\Lincoln,662,399,662,0,246316,256638,0,0,399,399,0.001554719,0
654,Illinois\Perry,0,217,0,217,171774,143923,0,0,217,217,0.001507751,1
1538,Missouri\Linn,1297,313,0,0,197001,209009,0,0,313,313,0.001497543,0
2141,Oklahoma\Atoka,743,94,489,89,90780,59859,254,5,89,89,0.001486827,1
2983,West Virginia\Calhoun,0,11,0,11,9333,7426,0,0,11,11,0.001481282,1
802,Iowa\Dallas,384,401,384,0,263668,270743,0,0,401,401,0.001481109,0
2931,Virginia\Wythe,163,72,163,72,51991,49459,0,0,72,72,0.001455751,1
3091,Wisconsin\Shawano,322,259,0,0,189064,183461,0,0,259,259,0.001411744,0
933,Kansas\Lyon,1060,403,1060,321,210190,228383,0,82,321,321,0.001405534,1
1470,Mississippi\Union,0,61,0,61,50250,43652,0,0,61,61,0.001397416,1
1086,Kentucky\Rowan,23,21,0,0,19458,15037,0,0,21,21,0.001396555,0
792,Iowa\Cass,667,335,667,335,264109,240732,0,0,335,335,0.001391589,1
706,Indiana\Floyd,22,17,22,17,13785,12238,0,0,17,17,0.001389116,1
2312,Pennsylvania\Tioga,88,150,0,150,96867,108961,0,0,150,150,0.001376639,1
2674,Texas\Kleberg,13,112,0,96,82645,71238,0,16,96,96,0.001347595,1
703,Indiana\Dubois,373,175,0,0,135172,130027,0,0,175,175,0.001345874,0
1843,New York\Cortland,18,186,18,81,61458,60365,0,105,81,81,0.001341837,1
2109,Ohio\Muskingum,37,106,37,106,76091,79187,0,0,106,106,0.001338604,1
1354,Minnesota\Marshall,418,987,418,0,786313,740407,0,0,987,987,0.001333051,0
793,Iowa\Cedar,203,367,203,367,299686,275638,0,0,367,367,0.001331456,1
862,Iowa\Story,261,372,238,372,328069,279417,23,0,372,372,0.001331343,1
625,Illinois\Johnson,0,64,0,64,53387,48244,0,0,64,64,0.00132659,1
714,Indiana\Hancock,196,207,196,207,159252,156589,0,0,207,207,0.001321932,1
2108,Ohio\Morrow,183,191,183,183,134935,139176,0,8,183,183,0.001314882,1
14,Alabama\Clay,38,17,38,17,14214,13010,0,0,17,17,0.001306687,1
2398,South Dakota\Faulk,0,499,0,499,373400,382776,0,0,499,499,0.001303635,1
695,Indiana\Clay,135,179,135,179,134068,137399,0,0,179,179,0.001302775,1
2264,Pennsylvania\Cambria,29,59,29,59,54580,45386,0,0,59,59,0.00129996,1
2408,South Dakota\Hyde,0,280,0,280,207217,216327,0,0,280,280,0.001294337,1
2295,Pennsylvania\McKean,7,17,7,17,15408,13156,0,0,17,17,0.001292186,1
1426,Mississippi\Itawamba,8,39,8,39,35149,30238,0,0,39,39,0.001289768,1
2258,Pennsylvania\Bedford,340,134,340,0,118727,104274,0,0,134,134,0.001285076,0
2286,Pennsylvania\Jefferson,26,68,26,68,52106,53151,0,0,68,68,0.001279374,1
758,Indiana\Spencer,430,169,430,169,110815,132508,0,0,169,169,0.001275395,1
1555,Missouri\Oregon,146,399,28,45,46181,35867,118,354,45,45,0.001254635,1
2047,North Dakota\Wells,1043,780,1043,780,630468,622310,0,0,780,780,0.001253395,1
2528,Tennessee\Union,44,16,0,16,19816,12808,0,0,16,16,0.001249219,1
526,Georgia\Whitfield,91,37,10,13,13800,10554,81,24,13,13,0.00123176,1
3051,Wisconsin\Florence,0,6,0,6,9417,4876,0,0,6,6,0.001230517,1
2996,West Virginia\Kanawha,10,5,10,5,3988,4080,0,0,5,5,0.00122549,1
2119,Ohio\Richland,135,147,135,0,110222,120285,0,0,147,147,0.001222098,0
2159,Oklahoma\Delaware,624,75,0,0,93816,62360,0,0,75,75,0.001202694,0
607,Illinois\Fayette,114,298,114,0,254549,248237,0,0,298,298,0.001200466,0
2296,Pennsylvania\Mercer,195,117,0,0,111556,97735,0,0,117,117,0.001197115,0
789,Iowa\Butler,338,396,338,396,343222,330867,0,0,396,396,0.001196856,1
2715,Texas\Nueces,4322,432,3377,0,369433,362586,945,0,432,432,0.001191441,0
1197,Maryland\Garrett,375,49,348,49,46019,41525,27,0,49,49,0.001180012,1
2901,Virginia\Northumberland,62,39,62,39,36896,33490,0,0,39,39,0.001164527,1
2994,West Virginia\Jackson,142,30,0,30,36786,25773,0,0,30,30,0.001164009,1
1856,New York\Lewis,130,113,0,113,92028,97216,0,0,113,113,0.00116236,1
1554,Missouri\Nodaway,42,340,42,340,377547,293281,0,0,340,340,0.001159298,1
2709,Texas\Morris,137,21,125,21,19798,18127,12,0,21,21,0.001158493,1
1027,Kentucky\Green,190,78,190,0,66938,67443,0,0,78,78,0.001156532,0
2094,Ohio\Licking,914,204,856,186,169136,161360,58,18,186,186,0.001152702,1
1242,Michigan\Chippewa,104,66,0,0,66095,57377,0,0,66,66,0.001150287,0
2862,Virginia\Cumberland,0,18,0,18,17149,15649,0,0,18,18,0.001150233,1
1502,Missouri\Christian,158,64,47,61,76040,53328,111,3,61,61,0.001143864,1
2311,Pennsylvania\Susquehanna,102,84,46,0,75947,73702,56,0,84,84,0.001139725,0
984,Kentucky\Adair,68,75,0,75,85073,66574,0,0,75,75,0.001126566,1
2827,Vermont\Essex,4,9,0,9,11557,8020,0,0,9,9,0.001122195,1
2989,West Virginia\Greenbrier,65,40,0,40,38498,35709,0,0,40,40,0.001120166,1
1590,Missouri\Washington,216,27,0,27,41299,24292,0,0,27,27,0.001111477,1
2105,Ohio\Monroe,16,33,16,33,29047,29697,0,0,33,33,0.001111223,1
2860,Virginia\Craig,6,11,0,11,11081,9947,0,0,11,11,0.001105861,1
3021,West Virginia\Summers,7,12,7,12,13599,10857,0,0,12,12,0.001105278,1
3092,Wisconsin\Sheboygan,144,172,111,0,157607,155878,33,0,172,172,0.001103427,0
2282,Pennsylvania\Fulton,70,67,70,67,52423,61066,0,0,67,67,0.001097174,1
3063,Wisconsin\Kewaunee,98,158,82,158,142190,144713,16,0,158,158,0.001091816,1
1085,Kentucky\Rockcastle,30,33,30,0,32456,30272,0,0,33,33,0.001090116,0
156,Arkansas\Sebastian,659,38,659,0,36839,35017,0,0,38,38,0.001085187,0
1107,Louisiana\Ascension,291,22,0,0,27024,20341,0,0,22,22,0.001081559,0
798,Iowa\Clay,490,316,490,316,304774,292462,0,0,316,316,0.001080482,1
752,Indiana\Randolph,79,233,0,233,210531,216595,0,0,233,233,0.00107574,1
642,Illinois\Marion,120,232,120,0,212144,216922,0,0,232,232,0.001069509,0
3025,West Virginia\Upshur,12,16,12,16,19540,14965,0,0,16,16,0.001069161,1
796,Iowa\Chickasaw,148,287,0,287,260520,271262,0,0,287,287,0.001058018,1
2480,Tennessee\Henderson,213,84,177,0,86150,79823,36,0,84,84,0.001052328,0
1226,Michigan\Alcona,138,25,138,25,28317,23802,0,0,25,25,0.001050332,1
2091,Ohio\Knox,58,134,58,0,142905,128695,0,0,134,134,0.001041221,0
2269,Pennsylvania\Clarion,82,63,0,63,67489,60546,0,0,63,63,0.001040531,1
602,Illinois\Douglas,0,255,0,0,252838,247840,0,0,255,255,0.00102889,0
1447,Mississippi\Neshoba,496,21,313,21,29821,20567,183,0,21,21,0.001021053,1
2008,North Dakota\Dunn,430,379,430,379,371237,374287,0,0,379,379,0.001012592,1
1396,Minnesota\Yellow Medicine,644,369,644,0,371339,364471,0,0,369,369,0.001012426,0
2789,Texas\Young,0,229,159,99,127775,97793,0,130,99,99,0.001012342,1
1101,Kentucky\Whitley,0,17,0,17,27758,16857,0,0,17,17,0.001008483,1
3007,West Virginia\Monongalia,48,15,48,15,16665,14947,0,0,15,15,0.001003546,1
1387,Minnesota\Traverse,0,333,0,333,311695,334992,0,0,333,333,0.000994054,1
2466,Tennessee\Fentress,31,26,31,26,34257,26344,0,0,26,26,0.000986942,1
2840,Virginia\Alleghany,0,8,0,8,7970,8144,0,0,8,8,0.000982318,1
989,Kentucky\Bath,112,47,112,47,54108,47863,0,0,47,47,0.000981969,1
1260,Michigan\Iosco,46,23,0,0,33134,23662,0,0,23,23,0.000972023,0
2261,Pennsylvania\Bradford,128,157,0,157,146588,163329,0,0,157,157,0.00096125,1
1587,Missouri\Texas,109,65,109,65,97334,67951,0,0,65,65,0.000956572,1
486,Georgia\Polk,55,13,0,13,15518,13653,0,0,13,13,0.000952172,1
850,Iowa\Page,52,247,52,247,215133,263037,0,0,247,247,0.000939031,1
772,Indiana\Washington,63,133,0,133,137866,142768,0,0,133,133,0.000931581,1
2123,Ohio\Seneca,628,240,628,240,241699,258061,0,0,240,240,0.000930013,1
3004,West Virginia\Mercer,8,9,8,9,11621,9697,0,0,9,9,0.000928122,1
2117,Ohio\Preble,222,181,222,0,204033,195108,0,0,181,181,0.000927691,0
1148,Louisiana\St. Bernard,0,4,0,4,3242,4347,0,0,4,4,0.000920175,1
2309,Pennsylvania\Somerset,197,109,197,109,120520,119396,0,0,109,109,0.000912928,1
826,Iowa\Jackson,46,191,0,191,191521,214246,0,0,191,191,0.000891499,1
1337,Minnesota\Houston,152,115,0,0,127579,129356,0,0,115,115,0.000889019,0
1833,New York\Allegany,207,103,187,63,74635,71285,20,40,63,63,0.000883776,1
2172,Oklahoma\Jefferson,330,70,330,70,119137,79289,0,0,70,70,0.000882846,1
2207,Oklahoma\Stephens,1194,89,479,67,127830,75937,715,22,67,67,0.00088231,1
869,Iowa\Washington,236,233,236,0,268778,264570,0,0,233,233,0.000880674,0
2455,Tennessee\Clay,0,24,0,24,31468,27263,0,0,24,24,0.000880314,1
790,Iowa\Calhoun,0,295,0,295,339478,337429,0,0,295,295,0.000874258,1
3087,Wisconsin\Rusk,95,61,95,61,81631,70073,0,0,61,61,0.000870521,1
1291,Michigan\Ontonagon,0,12,0,12,15232,13900,0,0,12,12,0.000863309,1
1229,Michigan\Alpena,34,38,26,38,59577,44122,8,0,38,38,0.000861248,1
3093,Wisconsin\Taylor,51,103,0,103,129825,119997,0,0,103,103,0.000858355,1
867,Iowa\Wapello,0,118,0,0,119253,138692,0,0,118,118,0.000850806,0
3034,Wisconsin\Ashland,14,18,14,18,26529,21243,0,0,18,18,0.000847338,1
7,Alabama\Butler,71,18,71,18,25240,21305,0,0,18,18,0.000844872,1
2310,Pennsylvania\Sullivan,27,13,27,13,14524,15422,0,0,13,13,0.000842952,1
412,Georgia\Dade,45,6,0,6,7382,7152,0,0,6,6,0.000838926,1
1331,Minnesota\Faribault,359,310,359,310,429245,370187,0,0,310,310,0.000837415,1
461,Georgia\Lincoln,8,3,8,3,6921,3625,0,0,3,3,0.000827586,1
1364,Minnesota\Olmsted,94,173,0,173,227550,209399,0,0,173,173,0.000826174,1
1853,New York\Herkimer,187,63,187,63,77940,76397,0,0,63,63,0.00082464,1
803,Iowa\Davis,125,111,125,0,131016,135167,0,0,111,111,0.000821206,0
2392,South Dakota\Day,291,323,291,0,386994,395007,0,0,323,323,0.000817707,0
2993,West Virginia\Harrison,10,21,10,21,26811,25745,0,0,21,21,0.000815692,1
1067,Kentucky\Mercer,104,48,104,48,74903,59424,0,0,48,48,0.000807754,1
3014,West Virginia\Pocahontas,16,15,16,15,23703,18693,0,0,15,15,0.000802439,1
2057,Ohio\Brown,68,111,0,0,173184,139279,0,0,111,111,0.000796961,0
685,Indiana\Adams,183,147,183,0,165835,185993,0,0,147,147,0.000790352,0
834,Iowa\Linn,554,231,545,0,295158,292561,9,0,231,231,0.000789579,0
2432,South Dakota\Stanley,0,173,0,173,233630,219367,0,0,173,173,0.000788633,1
1133,Louisiana\Lafourche,3201,403,0,41,63066,52358,0,362,41,41,0.00078307,1
841,Iowa\Marshall,762,219,762,219,295278,280597,0,0,219,219,0.000780479,1
3030,West Virginia\Wood,20,17,20,17,27405,21823,0,0,17,17,0.000778995,1
810,Iowa\Fayette,546,257,540,257,355542,333297,6,0,257,257,0.000771084,1
1526,Missouri\Howell,75,125,64,45,83313,58477,11,80,45,45,0.000769533,1
1560,Missouri\Pettis,555,435,555,202,262530,263154,0,233,202,202,0.000767611,1
1293,Michigan\Oscoda,10,6,10,6,8361,7870,0,0,6,6,0.000762389,1
2085,Ohio\Highland,197,150,197,0,203208,197691,0,0,150,150,0.00075876,0
2927,Virginia\Warren,58,12,43,12,13354,15827,15,0,12,12,0.000758198,1
2129,Ohio\Union,248,164,248,0,197888,216618,0,0,164,164,0.000757093,0
2043,North Dakota\Towner,861,428,861,428,550467,573310,0,0,428,428,0.000746542,1
2505,Tennessee\Moore,23,11,0,0,21201,14802,0,0,11,11,0.000743143,0
1561,Missouri\Phelps,183,63,17,20,51589,27212,166,43,20,20,0.00073497,1
3010,West Virginia\Nicholas,0,10,0,10,15290,13626,0,0,10,10,0.000733891,1
1051,Kentucky\Lewis,64,24,0,0,41140,32816,0,0,24,24,0.000731351,0
708,Indiana\Franklin,96,62,0,0,85367,85112,0,0,62,62,0.000728452,0
2992,West Virginia\Hardy,49,21,0,21,28329,29200,0,0,21,21,0.000719178,1
1014,Kentucky\Edmonson,14,25,14,25,45107,34892,0,0,25,25,0.000716497,1
2197,Oklahoma\Pawnee,37,46,0,37,60671,52158,0,9,37,37,0.000709383,1
601,Illinois\De Witt,0,128,0,128,185564,182583,0,0,128,128,0.000701051,1
1274,Michigan\Mackinac,0,8,0,0,12993,11467,0,0,8,8,0.000697654,0
3024,West Virginia\Tyler,3,8,3,8,11965,11506,0,0,8,8,0.000695289,1
1481,Missouri\Adair,71,93,71,93,144379,134006,0,0,93,93,0.000693999,1
2009,North Dakota\Eddy,573,200,573,200,272172,288664,0,0,200,200,0.000692847,1
1167,Louisiana\West Feliciana,32,20,32,20,12846,28872,0,0,20,20,0.000692713,1
829,Iowa\Johnson,2945,195,2945,195,282022,285139,0,0,195,195,0.000683877,1
799,Iowa\Clayton,14,198,14,0,296098,291664,0,0,198,198,0.000678863,0
753,Indiana\Ripley,29,83,29,83,120895,124071,0,0,83,83,0.000668972,1
2485,Tennessee\Jackson,79,13,75,13,27888,19476,4,0,13,13,0.000667488,1
115,Arkansas\Fulton,8,23,8,17,28904,25923,0,6,17,17,0.000655788,1
2314,Pennsylvania\Venango,35,19,35,19,30962,29030,0,0,19,19,0.000654495,1
2852,Virginia\Buckingham,39,16,39,16,28677,24485,0,0,16,16,0.000653461,1
746,Indiana\Perry,9,20,0,0,35963,30692,0,0,20,20,0.000651636,0
2509,Tennessee\Perry,86,9,86,9,19414,13814,0,0,9,9,0.000651513,1
1511,Missouri\Daviess,564,137,0,137,203722,210489,0,0,137,137,0.000650865,1
634,Illinois\Livingston,153,411,153,411,599112,632131,0,0,411,411,0.000650182,1
723,Indiana\Jefferson,9,40,9,40,67070,61745,0,0,40,40,0.000647826,1
2079,Ohio\Guernsey,20,33,20,0,49036,51740,0,0,33,33,0.000637804,0
822,Iowa\Howard,260,173,0,173,248796,273269,0,0,173,173,0.000633076,1
3015,West Virginia\Preston,23,55,23,28,46323,44902,0,27,28,28,0.00062358,1
2926,Virginia\Tazewell,330,18,302,18,31479,29097,28,0,18,18,0.00061862,1
3008,West Virginia\Monroe,10,18,10,18,31359,29160,0,0,18,18,0.000617284,1
828,Iowa\Jefferson,35,94,35,0,145015,153400,0,0,94,94,0.000612777,0
1332,Minnesota\Fillmore,11,194,11,0,330381,316843,0,0,194,194,0.000612291,0
1038,Kentucky\Jackson,21,14,21,0,33706,23043,0,0,14,14,0.00060756,0
2107,Ohio\Morgan,7,18,0,18,31263,29975,0,0,18,18,0.0006005,1
1280,Michigan\Menominee,24,30,0,30,59685,50289,0,0,30,30,0.000596552,1
599,Illinois\Cumberland,5,85,5,85,124539,143465,0,0,85,85,0.000592479,1
3065,Wisconsin\Lafayette,68,172,68,159,249866,276055,0,13,159,159,0.000575972,1
1495,Missouri\Camden,94,52,0,14,36363,24413,0,38,14,14,0.000573465,1
724,Indiana\Jennings,568,75,0,50,105121,87673,0,25,50,50,0.000570301,1
681,Illinois\Williamson,13,41,13,0,64773,72131,0,0,41,41,0.00056841,0
624,Illinois\Jo Daviess,118,107,118,107,196027,190246,0,0,107,107,0.00056243,1
2113,Ohio\Perry,18,44,18,38,58473,67787,0,6,38,38,0.000560579,1
594,Illinois\Clay,0,130,0,130,178258,235247,0,0,130,130,0.000552611,1
832,Iowa\Kossuth,637,313,637,313,573301,568629,0,0,313,313,0.000550447,1
2279,Pennsylvania\Fayette,100,30,87,30,74180,55185,13,0,30,30,0.000543626,1
2090,Ohio\Jefferson,80,14,0,0,31688,25857,0,0,14,14,0.000541439,0
2188,Oklahoma\Murray,0,23,0,13,38935,24296,0,10,13,13,0.000535068,1
2155,Oklahoma\Cotton,331,99,0,99,196644,185500,0,0,99,99,0.000533693,1
2920,Virginia\Smyth,188,18,157,0,30319,34332,31,0,18,18,0.000524292,0
2911,Virginia\Pulaski,241,14,0,14,21091,26732,0,0,14,14,0.000523717,1
785,Iowa\Boone,100,148,100,148,301744,283251,0,0,148,148,0.000522505,1
1064,Kentucky\Mason,28,30,28,30,78456,57923,0,0,30,30,0.000517929,1
1026,Kentucky\Grayson,35,63,35,45,103546,87091,0,18,45,45,0.000516701,1
751,Indiana\Putnam,0,79,0,79,130588,156037,0,0,79,79,0.00050629,1
1016,Kentucky\Estill,9,7,9,7,22546,14051,0,0,7,7,0.000498185,1
1374,Minnesota\Renville,0,293,0,293,587501,589089,0,0,293,293,0.000497378,1
12,Alabama\Choctaw,0,8,0,4,9261,8045,0,4,4,4,0.000497203,1
2454,Tennessee\Claiborne,37,17,37,0,43984,34385,0,0,17,17,0.000494402,0
2098,Ohio\Madison,202,119,0,0,225382,244231,0,0,119,119,0.000487244,0
636,Illinois\McDonough,75,123,0,0,267215,253450,0,0,123,123,0.000485303,0
3002,West Virginia\Marshall,69,11,0,11,30332,22769,0,0,11,11,0.000483113,1
3022,West Virginia\Taylor,11,5,11,5,13990,10403,0,0,5,5,0.000480631,1
2506,Tennessee\Morgan,9,9,9,9,20551,19463,0,0,9,9,0.000462416,1
1508,Missouri\Crawford,62,22,20,22,49599,47586,42,0,22,22,0.000462321,1
838,Iowa\Madison,1754,85,0,0,185223,184056,0,0,85,85,0.000461816,0
588,Illinois\Calhoun,0,22,0,0,49579,48502,0,0,22,22,0.00045359,0
2500,Tennessee\Marshall,56,44,0,28,63086,62486,0,16,28,28,0.0004481,1
1151,Louisiana\St. James,0,16,0,16,33602,37056,0,0,16,16,0.000431779,1
2086,Ohio\Hocking,28,6,28,6,16973,14048,0,0,6,6,0.000427107,1
673,Illinois\Vermilion,677,174,677,174,428098,409458,0,0,174,174,0.000424952,1
784,Iowa\Black Hawk,197,116,197,0,263232,273813,0,0,116,116,0.000423647,0
944,Kansas\Neosho,0,74,0,74,166135,175355,0,0,74,74,0.000422001,1
2909,Virginia\Prince George,0,8,20,8,22275,19030,0,0,8,8,0.000420389,1
1159,Louisiana\Terrebonne,381,618,267,9,22157,21516,114,609,9,9,0.000418293,1
2980,West Virginia\Braxton,0,6,0,6,12853,14657,0,0,6,6,0.000409361,1
1087,Kentucky\Russell,275,14,275,14,46183,34915,0,0,14,14,0.000400974,1
3019,West Virginia\Ritchie,23,7,10,0,21784,17571,13,0,7,7,0.000398384,0
2205,Oklahoma\Seminole,782,194,501,19,70440,48012,281,175,19,19,0.000395734,1
2426,South Dakota\Perkins,611,155,611,0,427292,393243,0,0,155,155,0.000394158,0
870,Iowa\Wayne,78,78,0,0,192106,198977,0,0,78,78,0.000392005,0
1456,Mississippi\Prentiss,184,15,74,15,44605,38422,110,0,15,15,0.000390401,1
839,Iowa\Mahaska,87,106,0,0,244728,273911,0,0,106,106,0.000386987,0
2401,South Dakota\Haakon,0,125,0,125,324654,324595,0,0,125,125,0.000385095,1
2056,Ohio\Belmont,15,13,0,13,42554,34967,0,0,13,13,0.000371779,1
1155,Louisiana\St. Mary,22,23,22,0,63747,63044,0,0,23,23,0.000364825,0
716,Indiana\Hendricks,23,72,0,0,157591,200890,0,0,72,72,0.000358405,0
2026,North Dakota\Mountrail,0,205,0,205,652365,578761,0,0,205,205,0.000354205,1
2917,Virginia\Russell,134,12,50,12,35431,34004,84,0,12,12,0.0003529,1
2063,Ohio\Clinton,70,66,70,0,195889,187727,0,0,66,66,0.000351574,0
2103,Ohio\Mercer,75,86,0,0,265784,248701,0,0,86,86,0.000345797,0
1394,Minnesota\Winona,25,62,25,62,191308,180009,0,0,62,62,0.000344427,1
1341,Minnesota\Jackson,620,113,620,113,371172,329974,0,0,113,113,0.000342451,1
715,Indiana\Harrison,61,29,61,0,99095,85030,0,0,29,29,0.000341056,0
2131,Ohio\Vinton,0,4,0,4,14601,11827,0,0,4,4,0.000338209,1
2128,Ohio\Tuscarawas,176,26,176,26,81826,78421,0,0,26,26,0.000331544,1
805,Iowa\Delaware,0,106,0,0,290993,321161,0,0,106,106,0.000330053,0
609,Illinois\Franklin,0,50,0,0,183694,152745,0,0,50,50,0.000327343,0
997,Kentucky\Breckinridge,13,37,13,37,124947,116614,0,0,37,37,0.000317286,1
1381,Minnesota\Sibley,328,99,184,0,313749,318627,144,0,99,99,0.000310708,0
2066,Ohio\Crawford,18,67,18,0,200751,221930,0,0,67,67,0.000301897,0
1352,Minnesota\McLeod,45,70,45,70,218715,236951,0,0,70,70,0.00029542,1
865,Iowa\Union,0,43,0,0,139533,147608,0,0,43,43,0.000291312,0
2046,North Dakota\Ward,770,240,770,240,843803,829363,0,0,240,240,0.000289379,1
1518,Missouri\Gentry,17,46,17,0,173682,160441,0,0,46,46,0.00028671,0
2444,Tennessee\Benton,22,11,0,0,37596,38546,0,0,11,11,0.000285373,0
783,Iowa\Benton,38,107,38,107,356254,381759,0,0,107,107,0.000280282,1
739,Indiana\Morgan,45,32,25,0,92985,114176,20,0,32,32,0.000280269,0
2510,Tennessee\Pickett,0,4,0,4,17573,14518,0,0,4,4,0.00027552,1
1010,Kentucky\Clinton,34,319,34,7,33741,25989,0,312,7,7,0.000269345,1
2987,West Virginia\Gilmer,0,3,0,3,12096,11674,0,0,3,3,0.000256981,1
840,Iowa\Marion,699,51,699,51,183327,199958,0,0,51,51,0.000255054,1
830,Iowa\Jones,559,62,559,62,271236,255729,0,0,62,62,0.000242444,1
702,Indiana\Delaware,467,37,0,37,143432,160372,0,0,37,37,0.000230714,1
1070,Kentucky\Montgomery,57,9,57,9,53895,40011,0,0,9,9,0.000224938,1
1521,Missouri\Harrison,0,59,0,0,236781,264079,0,0,59,59,0.000223418,0
700,Indiana\Decatur,0,36,0,36,183719,162621,0,0,36,36,0.000221374,1
808,Iowa\Dubuque,0,49,0,49,237390,224256,0,0,49,49,0.0002185,1
774,Indiana\Wells,73,39,73,0,184131,189036,0,0,39,39,0.00020631,0
868,Iowa\Warren,80,37,80,37,160336,183991,0,0,37,37,0.000201097,1
613,Illinois\Grundy,0,40,0,0,206081,206043,0,0,40,40,0.000194134,0
2306,Pennsylvania\Potter,0,8,0,8,40443,41982,0,0,8,8,0.000190558,1
584,Illinois\Bond,5,33,5,0,203316,176740,0,0,33,33,0.000186715,0
697,Indiana\Crawford,13,3,13,3,17136,16206,0,0,3,3,0.000185117,1
743,Indiana\Orange,0,10,0,0,58813,56872,0,0,10,10,0.000175833,0
3040,Wisconsin\Calumet,50,21,50,21,128524,120851,0,0,21,21,0.000173768,1
931,Kansas\Linn,0,29,0,29,133783,167831,0,0,29,29,0.000172793,1
664,Illinois\Saline,0,20,0,0,96241,117680,0,0,20,20,0.000169952,0
797,Iowa\Clarke,0,16,0,16,105505,98944,0,0,16,16,0.000161708,1
2083,Ohio\Harrison,0,6,0,6,38737,38067,0,0,6,6,0.000157617,1
651,Illinois\Moultrie,24,28,0,28,159120,194158,0,0,28,28,0.000144212,1
823,Iowa\Humboldt,0,28,0,0,256184,220139,0,0,28,28,0.000127192,0
866,Iowa\Van Buren,12,17,0,17,144945,140830,0,0,17,17,0.000120713,1
1053,Kentucky\Livingston,30,7,30,7,61253,62457,0,0,7,7,0.000112077,1
856,Iowa\Poweshiek,12,31,12,0,267749,286815,0,0,31,31,0.000108084,0
717,Indiana\Henry,0,17,0,17,157458,158443,0,0,17,17,0.000107294,1
873,Iowa\Winneshiek,0,31,0,31,244187,305262,0,0,31,31,0.000101552,1
154,Arkansas\Scott,0,3,0,3,31811,30108,0,0,3,3,9.96E-05,1
2124,Ohio\Shelby,15,18,15,18,192808,183182,0,0,18,18,9.83E-05,1
1065,Kentucky\Meade,10,6,10,6,65155,63718,0,0,6,6,9.42E-05,1
2081,Ohio\Hancock,74,20,32,0,228555,212775,42,0,20,20,9.40E-05,0
780,Iowa\Allamakee,287,29,287,17,164379,185754,0,12,17,17,9.15E-05,1
623,Illinois\Jersey,36,11,36,11,158075,126072,0,0,11,11,8.73E-05,1
596,Illinois\Coles,18,21,18,0,235141,245919,0,0,21,21,8.54E-05,0
640,Illinois\Macoupin,18,30,18,30,336959,371038,0,0,30,30,8.09E-05,1
947,Kansas\Osage,354,18,354,18,203919,251355,0,0,18,18,7.16E-05,1
831,Iowa\Keokuk,5,17,5,17,255215,240609,0,0,17,17,7.07E-05,1
670,Illinois\Stephenson,79,22,79,22,306929,315752,0,0,22,22,6.97E-05,1
668,Illinois\Shelby,78,25,0,25,346962,362661,0,0,25,25,6.89E-05,1
778,Iowa\Adair,0,17,0,17,243656,251540,0,0,17,17,6.76E-05,1
787,Iowa\Buchanan,224,19,224,0,330796,318462,0,0,19,19,5.97E-05,0
821,Iowa\Henry,6,12,6,12,192814,220657,0,0,12,12,5.44E-05,1
1512,Missouri\DeKalb,0,9,6,9,161433,168328,0,0,9,9,5.35E-05,1
800,Iowa\Clinton,122,18,122,18,355595,372073,0,0,18,18,4.84E-05,1
2069,Ohio\Defiance,0,9,0,0,202932,198111,0,0,9,9,4.54E-05,0
860,Iowa\Shelby,0,21,0,15,333693,344274,0,6,15,15,4.36E-05,1
614,Illinois\Hamilton,0,8,0,8,191879,195256,0,0,8,8,4.10E-05,1
1366,Minnesota\Pennington,110,9,110,0,265315,225497,0,0,9,9,3.99E-05,0
2073,Ohio\Fayette,11,7,11,7,197629,180569,0,0,7,7,3.88E-05,1
639,Illinois\Macon,31,12,31,0,280663,321693,0,0,12,12,3.73E-05,0
863,Iowa\Tama,8,13,8,13,380834,351667,0,0,13,13,3.70E-05,1
629,Illinois\Knox,0,10,0,10,301485,288679,0,0,10,10,3.46E-05,1
2112,Ohio\Paulding,0,7,0,7,236605,205293,0,0,7,7,3.41E-05,1
2055,Ohio\Auglaize,0,6,0,6,192248,191496,0,0,6,6,3.13E-05,1
1351,Minnesota\Lyon,19,11,19,11,389540,379676,0,0,11,11,2.90E-05,1
981,Kansas\Woodson,0,4,0,4,107416,153922,0,0,4,4,2.60E-05,1
815,Iowa\Grundy,6,7,6,7,300828,301114,0,0,7,7,2.32E-05,1
876,Iowa\Wright,24,7,24,7,309054,344622,0,0,7,7,2.03E-05,1
2137,Ohio\Wyandot,0,4,0,4,202008,201977,0,0,4,4,1.98E-05,1
1373,Minnesota\Redwood,25,9,25,9,508698,489626,0,0,9,9,1.84E-05,1
872,Iowa\Winnebago,0,4,0,4,235622,221994,0,0,4,4,1.80E-05,1
795,Iowa\Cherokee,0,5,0,5,275527,290417,0,0,5,5,1.72E-05,1
1361,Minnesota\Nicollet,0,4,0,4,249986,249992,0,0,4,4,1.60E-05,1
819,Iowa\Hardin,6,3,6,3,307518,306237,0,0,3,3,9.80E-06,1
1377,Minnesota\Roseau,23,3,23,3,462247,445387,0,0,3,3,6.74E-06,1
19,Alabama\Coosa,22,0,0,0,8465,4309,0,0,0,0,0,#DIV/0!
29,Alabama\Fayette,394,0,314,0,24062,27578,80,0,0,0,0,#DIV/0!
33,Alabama\Hale,92,0,0,0,35596,29891,0,0,0,0,0,#DIV/0!
38,Alabama\Lamar,93,0,79,0,18567,13868,14,0,0,0,0,#DIV/0!
54,Alabama\Pickens,591,0,0,0,28557,24587,0,0,0,0,0,#DIV/0!
66,Alabama\Wilcox,168,0,63,0,33364,22316,105,0,0,0,0,#DIV/0!
67,Alabama\Winston,41,0,28,0,20526,13459,13,0,0,0,0,#DIV/0!
96,Arkansas\Bradley,917,0,917,0,9646,5505,0,0,0,0,0,#DIV/0!
100,Arkansas\Clark,416,0,416,0,29855,26515,0,0,0,0,0,#DIV/0!
103,Arkansas\Cleveland,0,0,0,0,9343,6041,0,0,0,0,0,#DIV/0!
110,Arkansas\Dallas,0,0,0,0,4942,3223,0,0,0,0,0,#DIV/0!
119,Arkansas\Hempstead,1713,0,0,0,66626,48947,0,0,0,0,0,#DIV/0!
135,Arkansas\Marion,27,0,27,0,28674,19258,0,0,0,0,0,#DIV/0!
155,Arkansas\Searcy,38,0,38,0,38379,24964,0,0,0,0,0,#DIV/0!
157,Arkansas\Sevier,256,0,0,49,30575,27381,0,0,0,0,0,#DIV/0!
204,California\San Francisco,6,0,6,0,7,9,0,0,0,0,0,#DIV/0!
236,Colorado\Clear Creek,81,0,75,0,1431,299,6,0,0,0,0,#DIV/0!
250,Colorado\Gilpin,0,0,0,0,307,389,0,0,0,0,0,#DIV/0!
266,Colorado\Mineral,847,0,757,0,1756,540,90,0,0,0,0,#DIV/0!
321,Florida\Franklin,0,0,0,0,0,797,0,0,0,0,0,#DIV/0!
325,Florida\Gulf,0,0,0,0,1269,544,0,0,0,0,0,#DIV/0!
341,Florida\Liberty,0,0,0,0,661,1169,0,0,0,0,0,#DIV/0!
365,Florida\Taylor,0,0,0,0,1849,2270,0,0,0,0,0,#DIV/0!
386,Georgia\Bryan,0,0,0,0,6481,4406,0,0,0,0,0,#DIV/0!
397,Georgia\Chattahoochee,0,0,0,0,434,294,0,0,0,0,0,#DIV/0!
402,Georgia\Clayton,45,0,3,0,553,224,42,0,0,0,0,#DIV/0!
419,Georgia\Douglas,151,0,151,0,2937,2179,0,0,0,0,0,#DIV/0!
445,Georgia\Heard,0,0,0,0,5858,3443,0,0,0,0,0,#DIV/0!
462,Georgia\Long,475,0,475,0,4842,2819,0,0,0,0,0,#DIV/0!
477,Georgia\Muscogee,0,0,0,0,2830,1997,0,0,0,0,0,#DIV/0!
489,Georgia\Quitman,0,0,0,0,5467,2396,0,0,0,0,0,#DIV/0!
490,Georgia\Rabun,550,0,0,0,2432,3647,0,0,0,0,0,#DIV/0!
501,Georgia\Talbot,66,0,66,0,6665,4855,0,0,0,0,0,#DIV/0!
511,Georgia\Treutlen,4982,0,4982,0,10541,9657,0,0,0,0,0,#DIV/0!
516,Georgia\Upson,644,0,638,0,12764,8204,6,0,0,0,0,#DIV/0!
567,Idaho\Lewis,310,0,5,0,184110,158721,305,0,0,0,0,#DIV/0!
576,Idaho\Shoshone,0,0,0,0,1319,791,0,0,0,0,0,#DIV/0!
592,Illinois\Christian,31,0,31,0,430356,352741,0,0,0,0,0,#DIV/0!
604,Illinois\Edgar,162,0,162,0,328303,326251,0,0,0,0,0,#DIV/0!
605,Illinois\Edwards,104,0,104,0,100512,88078,0,0,0,0,0,#DIV/0!
621,Illinois\Jasper,0,0,0,0,214426,218212,0,0,0,0,0,#DIV/0!
628,Illinois\Kendall,2067,0,2067,0,160527,123621,0,0,0,0,0,#DIV/0!
649,Illinois\Montgomery,387,0,387,0,314991,346716,0,0,0,0,0,#DIV/0!
661,Illinois\Richland,45,0,45,0,185617,167313,0,0,0,0,0,#DIV/0!
669,Illinois\Stark,10,0,10,0,159819,159464,0,0,0,0,0,#DIV/0!
688,Indiana\Benton,4046,0,4046,0,262575,247354,0,0,0,0,0,#DIV/0!
689,Indiana\Blackford,13,0,13,0,77137,81200,0,0,0,0,0,#DIV/0!
705,Indiana\Fayette,30,0,30,0,75760,63789,0,0,0,0,0,#DIV/0!
707,Indiana\Fountain,0,0,0,0,163135,190497,3,0,0,0,0,#DIV/0!
711,Indiana\Grant,0,0,0,0,191061,171451,0,0,0,0,0,#DIV/0!
718,Indiana\Howard,58,0,0,0,151611,134536,0,0,0,0,0,#DIV/0!
722,Indiana\Jay,0,0,0,0,176787,156302,21,0,0,0,0,#DIV/0!
731,Indiana\Lawrence,285,0,0,0,68084,70792,0,0,0,0,0,#DIV/0!
747,Indiana\Pike,7,0,7,0,58813,65045,0,0,0,0,0,#DIV/0!
756,Indiana\Scott,23,0,0,0,48233,38376,0,0,0,0,0,#DIV/0!
765,Indiana\Union,5,0,5,0,63741,63892,0,0,0,0,0,#DIV/0!
766,Indiana\Vanderburgh,0,0,0,0,67241,70568,0,0,0,0,0,#DIV/0!
767,Indiana\Vermillion,0,0,0,0,112886,100269,0,0,0,0,0,#DIV/0!
771,Indiana\Warrick,161,0,120,0,88934,88565,41,0,0,0,0,#DIV/0!
779,Iowa\Adams,0,0,0,0,167805,165853,0,0,0,0,0,#DIV/0!
781,Iowa\Appanoose,0,0,0,0,120442,111843,0,0,0,0,0,#DIV/0!
782,Iowa\Audubon,0,0,0,0,245172,251918,0,0,0,0,0,#DIV/0!
791,Iowa\Carroll,196,0,196,0,329601,328077,0,0,0,0,0,#DIV/0!
794,Iowa\Cerro Gordo,476,0,476,0,319671,306276,0,0,0,0,0,#DIV/0!
804,Iowa\Decatur,0,0,0,0,116729,126992,0,0,0,0,0,#DIV/0!
812,Iowa\Franklin,0,0,0,0,345951,336741,0,0,0,0,0,#DIV/0!
814,Iowa\Greene,504,0,504,0,321744,325589,0,0,0,0,0,#DIV/0!
816,Iowa\Guthrie,2549,0,2546,0,282175,262152,3,0,0,0,0,#DIV/0!
817,Iowa\Hamilton,4,0,4,0,326254,305126,0,0,0,0,0,#DIV/0!
824,Iowa\Ida,0,0,0,0,251150,234140,0,0,0,0,0,#DIV/0!
825,Iowa\Iowa,0,0,0,0,281066,275469,0,0,0,0,0,#DIV/0!
836,Iowa\Lucas,0,0,0,0,91187,101496,0,0,0,0,0,#DIV/0!
842,Iowa\Mills,0,0,0,0,175012,182255,0,0,0,0,0,#DIV/0!
845,Iowa\Monroe,0,0,0,0,122892,111752,0,0,0,0,0,#DIV/0!
857,Iowa\Ringgold,0,0,30,0,180805,178811,0,0,0,0,0,#DIV/0!
864,Iowa\Taylor,0,0,0,0,209605,211993,0,0,0,0,0,#DIV/0!
871,Iowa\Webster,8,0,8,0,426609,383606,0,0,0,0,0,#DIV/0!
878,Kansas\Allen,49,0,0,0,145419,129459,0,0,0,0,0,#DIV/0!
886,Kansas\Chase,230,0,230,0,67863,56042,0,0,0,0,0,#DIV/0!
887,Kansas\Chautauqua,0,0,0,0,51634,39655,0,0,0,0,0,#DIV/0!
902,Kansas\Elk,479,0,479,0,65229,51358,0,0,0,0,0,#DIV/0!
982,Kansas\Wyandotte,236,0,236,0,12409,7328,0,0,0,0,0,#DIV/0!
1000,Kentucky\Caldwell,2423,0,2423,0,86512,85467,0,0,0,0,0,#DIV/0!
1012,Kentucky\Cumberland,0,0,0,0,32640,17657,0,0,0,0,0,#DIV/0!
1031,Kentucky\Harlan,0,0,0,0,690,276,0,0,0,0,0,#DIV/0!
1041,Kentucky\Johnson,0,0,0,0,6773,4941,0,0,0,0,0,#DIV/0!
1043,Kentucky\Knott,0,0,0,0,2704,1776,0,0,0,0,0,#DIV/0!
1049,Kentucky\Leslie,0,0,0,0,154,205,0,0,0,0,0,#DIV/0!
1050,Kentucky\Letcher,0,0,0,0,757,433,0,0,0,0,0,#DIV/0!
1055,Kentucky\Lyon,0,0,0,0,29365,23614,0,0,0,0,0,#DIV/0!
1060,Kentucky\Magoffin,0,0,0,0,13885,7888,0,0,0,0,0,#DIV/0!
1063,Kentucky\Martin,0,0,0,0,1073,312,0,0,0,0,0,#DIV/0!
1066,Kentucky\Menifee,12,0,12,0,15083,9975,0,0,0,0,0,#DIV/0!
1080,Kentucky\Perry,0,0,0,0,2394,899,0,0,0,0,0,#DIV/0!
1081,Kentucky\Pike,0,0,0,0,3025,2096,0,0,0,0,0,#DIV/0!
1108,Louisiana\Assumption,0,0,0,0,51515,55981,0,0,0,0,0,#DIV/0!
1118,Louisiana\Claiborne,0,0,0,0,13227,12518,0,0,0,0,0,#DIV/0!
1130,Louisiana\Jefferson,1084,0,34,0,5704,757,1050,0,0,0,0,#DIV/0!
1134,Louisiana\La Salle,0,0,0,0,5677,3983,0,0,0,0,0,#DIV/0!
1149,Louisiana\St. Charles,21,0,0,0,0,1866,0,0,0,0,0,#DIV/0!
1152,Louisiana\St. John the Baptist,0,0,0,0,9787,7960,0,0,0,0,0,#DIV/0!
1164,Louisiana\Webster,38,0,29,0,16910,10061,9,0,0,0,0,#DIV/0!
1220,Massachusetts\Nantucket,374,0,0,0,447,621,0,0,0,0,0,#DIV/0!
1231,Michigan\Arenac,25,0,14,0,74429,63020,11,0,0,0,0,#DIV/0!
1243,Michigan\Clare,608,0,0,0,37361,30675,0,0,0,0,0,#DIV/0!
1273,Michigan\Luce,0,0,0,0,3375,4259,0,0,0,0,0,#DIV/0!
1285,Michigan\Montmorency,0,0,0,0,12623,14581,0,0,0,0,0,#DIV/0!
1302,Michigan\Schoolcraft,41,0,41,0,10843,5348,0,0,0,0,0,#DIV/0!
1318,Minnesota\Carlton,2096,0,56,0,43881,42431,2040,0,0,0,0,#DIV/0!
1329,Minnesota\Dodge,0,0,0,0,226101,202525,0,0,0,0,0,#DIV/0!
1340,Minnesota\Itasca,0,0,0,0,43934,40139,5,0,0,0,0,#DIV/0!
1342,Minnesota\Kanabec,374,0,374,0,70775,65870,0,0,0,0,0,#DIV/0!
1344,Minnesota\Kittson,1437,0,1437,0,439631,391057,0,0,0,0,0,#DIV/0!
1345,Minnesota\Koochiching,16,0,16,0,26026,24674,0,0,0,0,0,#DIV/0!
1348,Minnesota\Lake of the Woods,0,0,0,0,58265,56199,0,0,0,0,0,#DIV/0!
1353,Minnesota\Mahnomen,0,0,0,0,144726,178461,0,0,0,0,0,#DIV/0!
1360,Minnesota\Murray,0,0,0,0,390676,374929,0,0,0,0,0,#DIV/0!
1362,Minnesota\Nobles,0,0,0,0,389614,350983,0,0,0,0,0,#DIV/0!
1372,Minnesota\Red Lake,225,0,225,0,186069,167739,0,0,0,0,0,#DIV/0!
1378,Minnesota\St. Louis,197,0,167,0,70698,60400,30,0,0,0,0,#DIV/0!
1390,Minnesota\Waseca,147,0,147,0,229573,213590,0,0,0,0,0,#DIV/0!
1398,Mississippi\Adams,40,0,40,0,25948,20287,0,0,0,0,0,#DIV/0!
1399,Mississippi\Alcorn,175,0,0,0,43551,43270,0,0,0,0,0,#DIV/0!
1402,Mississippi\Benton,0,0,0,0,27077,29180,0,0,0,0,0,#DIV/0!
1408,Mississippi\Claiborne,0,0,0,0,26580,21997,0,0,0,0,0,#DIV/0!
1436,Mississippi\Lawrence,0,0,0,0,26999,18156,0,0,0,0,0,#DIV/0!
1443,Mississippi\Marion,166,0,0,0,27349,18183,0,0,0,0,0,#DIV/0!
1455,Mississippi\Pontotoc,1920,0,1842,0,61433,64245,78,0,0,0,0,#DIV/0!
1482,Missouri\Andrew,0,0,0,0,169859,137991,0,0,0,0,0,#DIV/0!
1491,Missouri\Buchanan,23,0,23,0,143887,136111,0,0,0,0,0,#DIV/0!
1493,Missouri\Caldwell,164,0,0,0,155262,153006,0,0,0,0,0,#DIV/0!
1498,Missouri\Carter,0,0,0,0,14627,9589,0,0,0,0,0,#DIV/0!
1500,Missouri\Cedar,150,0,150,0,72306,63257,0,0,0,0,0,#DIV/0!
1504,Missouri\Clay,42,0,0,0,75144,57238,0,0,0,0,0,#DIV/0!
1505,Missouri\Clinton,0,0,0,0,154079,126853,0,0,0,0,0,#DIV/0!
1522,Missouri\Henry,482,0,0,0,184772,200171,0,0,0,0,0,#DIV/0!
1523,Missouri\Hickory,364,0,0,0,52656,57263,0,0,0,0,0,#DIV/0!
1532,Missouri\Knox,0,0,0,0,170179,193295,0,0,0,0,0,#DIV/0!
1542,Missouri\Madison,0,0,0,0,28101,24082,0,0,0,0,0,#DIV/0!
1545,Missouri\Mercer,0,0,0,0,105829,119401,0,0,0,0,0,#DIV/0!
1559,Missouri\Perry,0,0,0,0,129395,122031,0,0,0,0,0,#DIV/0!
1566,Missouri\Putnam,0,0,0,0,113888,124729,0,0,0,0,0,#DIV/0!
1578,Missouri\Schuyler,0,0,0,0,78971,83792,0,0,0,0,0,#DIV/0!
1579,Missouri\Scotland,326,0,0,0,148298,158418,0,0,0,0,0,#DIV/0!
1585,Missouri\Sullivan,3,0,3,0,151819,158840,0,0,0,0,0,#DIV/0!
1591,Missouri\Wayne,38,0,38,0,29204,27981,0,0,0,0,0,#DIV/0!
1593,Missouri\Worth,0,0,0,0,82128,69970,0,0,0,0,0,#DIV/0!
1801,New Mexico\Cibola,2319,0,1623,0,17011,3906,696,0,0,0,0,#DIV/0!
1809,New Mexico\Harding,0,0,0,0,19854,21328,0,0,0,0,0,#DIV/0!
1852,New York\Hamilton,0,0,0,0,156,251,0,0,0,0,0,#DIV/0!
1871,New York\Putnam,0,0,0,0,1286,1640,0,0,0,0,0,#DIV/0!
1909,North Carolina\Camden,24,0,0,0,47647,46753,24,0,0,0,0,#DIV/0!
1914,North Carolina\Cherokee,178,0,93,0,6547,7619,85,0,0,0,0,#DIV/0!
1964,North Carolina\Pasquotank,29,0,29,0,79958,67720,0,0,0,0,0,#DIV/0!
1983,North Carolina\Tyrrell,0,0,0,0,51689,57831,0,0,0,0,0,#DIV/0!
1996,North Dakota\Adams,0,0,0,0,407315,380034,0,0,0,0,0,#DIV/0!
1999,North Dakota\Billings,0,0,0,0,120203,131319,0,0,0,0,0,#DIV/0!
2000,North Dakota\Bottineau,0,0,0,0,891145,772989,0,0,0,0,0,#DIV/0!
2002,North Dakota\Burke,0,0,0,0,425483,434636,0,0,0,0,0,#DIV/0!
2005,North Dakota\Cavalier,0,0,0,0,812288,871523,0,0,0,0,0,#DIV/0!
2012,North Dakota\Golden Valley,896,0,896,0,231840,242607,0,0,0,0,0,#DIV/0!
2016,North Dakota\Hettinger,0,0,0,0,582789,558544,0,0,0,0,0,#DIV/0!
2021,North Dakota\McIntosh,0,0,0,0,372247,397247,0,0,0,0,0,#DIV/0!
2031,North Dakota\Ramsey,0,0,0,0,656379,622710,0,0,0,0,0,#DIV/0!
2033,North Dakota\Renville,0,0,0,0,489164,445777,0,0,0,0,0,#DIV/0!
2035,North Dakota\Rolette,0,0,0,0,384659,365520,0,0,0,0,0,#DIV/0!
2037,North Dakota\Sheridan,0,0,0,0,354766,347268,0,0,0,0,0,#DIV/0!
2038,North Dakota\Sioux,0,0,0,0,148797,155901,0,0,0,0,0,#DIV/0!
2039,North Dakota\Slope,460,0,0,0,269563,245006,0,0,0,0,0,#DIV/0!
2051,Ohio\Allen,375,0,0,0,170421,163025,0,0,0,0,0,#DIV/0!
2100,Ohio\Marion,25,0,25,0,189598,174829,0,0,0,0,0,#DIV/0!
2120,Ohio\Ross,0,0,0,0,152574,153693,0,0,0,0,0,#DIV/0!
2156,Oklahoma\Craig,0,0,0,11,133444,110906,0,0,0,0,0,#DIV/0!
2202,Oklahoma\Pushmataha,524,0,430,101,47707,37878,94,0,0,0,0,#DIV/0!
2265,Pennsylvania\Cameron,0,0,0,0,2034,1631,0,0,0,0,0,#DIV/0!
2283,Pennsylvania\Greene,47,0,35,0,66754,36316,12,0,0,0,0,#DIV/0!
2285,Pennsylvania\Indiana,2307,0,2303,0,112999,85418,4,0,0,0,0,#DIV/0!
2338,South Carolina\Cherokee,120,0,97,0,18656,16610,23,0,0,0,0,#DIV/0!
2347,South Carolina\Fairfield,224,0,0,0,10550,7288,0,0,0,0,0,#DIV/0!
2354,South Carolina\Jasper,0,0,0,0,8565,8730,0,0,0,0,0,#DIV/0!
2360,South Carolina\McCormick,0,0,0,0,7146,3572,0,0,0,0,0,#DIV/0!
2375,South Dakota\Aurora,0,0,0,0,228775,267707,0,0,0,0,0,#DIV/0!
2389,South Dakota\Corson,1193,0,0,0,372883,346430,0,0,0,0,0,#DIV/0!
2394,South Dakota\Dewey,0,0,0,0,249994,214442,0,0,0,0,0,#DIV/0!
2417,South Dakota\McCook,34,0,0,0,289157,299530,0,0,0,0,0,#DIV/0!
2419,South Dakota\Marshall,642,0,642,0,328243,315968,0,0,0,0,0,#DIV/0!
2421,South Dakota\Mellette,1020,0,1020,0,127274,117445,0,0,0,0,0,#DIV/0!
2422,South Dakota\Miner,0,0,0,0,201746,231483,0,0,0,0,0,#DIV/0!
2427,South Dakota\Potter,0,0,0,0,355942,357337,0,0,0,0,0,#DIV/0!
2429,South Dakota\Sanborn,0,0,0,0,175058,221771,0,0,0,0,0,#DIV/0!
2440,South Dakota\Ziebach,0,0,0,0,258648,175611,0,0,0,0,0,#DIV/0!
2473,Tennessee\Hamblen,0,0,0,0,38874,27349,0,0,0,0,0,#DIV/0!
2475,Tennessee\Hancock,21,0,21,0,23120,15608,0,0,0,0,0,#DIV/0!
2483,Tennessee\Houston,0,0,0,0,18392,11828,0,0,0,0,0,#DIV/0!
2496,Tennessee\McNairy,669,0,669,0,68318,61456,0,0,0,0,0,#DIV/0!
2512,Tennessee\Putnam,102,0,0,0,41208,31445,0,0,0,0,0,#DIV/0!
2517,Tennessee\Scott,0,0,0,0,11977,14938,0,0,0,0,0,#DIV/0!
2518,Tennessee\Sequatchie,20,0,20,0,12595,10003,0,0,0,0,0,#DIV/0!
2527,Tennessee\Unicoi,4,0,4,0,1785,1886,0,0,0,0,0,#DIV/0!
2529,Tennessee\Van Buren,0,0,0,0,14267,11010,0,0,0,0,0,#DIV/0!
2603,Texas\Duval,4596,0,0,523,120349,59968,0,0,0,0,0,#DIV/0!
2661,Texas\Jim Hogg,0,0,0,12,9820,9553,0,0,0,0,0,#DIV/0!
2672,Texas\King,0,0,0,0,29350,23420,0,0,0,0,0,#DIV/0!
2688,Texas\Loving,0,0,0,0,0,594,0,0,0,0,0,#DIV/0!
2746,Texas\Shackelford,0,0,0,0,71474,54965,0,0,0,0,0,#DIV/0!
2752,Texas\Stephens,226,0,0,0,67120,54403,0,0,0,0,0,#DIV/0!
2759,Texas\Terrell,0,280,0,0,15124,1980,0,280,0,0,0,#DIV/0!
2761,Texas\Throckmorton,1358,0,1358,0,94518,107555,0,0,0,0,0,#DIV/0!
2762,Texas\Titus,490,0,457,0,42079,31111,33,0,0,0,0,#DIV/0!
2842,Virginia\Amherst,147,0,0,0,21010,19359,0,0,0,0,0,#DIV/0!
2848,Virginia\Bland,10,0,10,0,19583,14090,0,0,0,0,0,#DIV/0!
2851,Virginia\Buchanan,0,0,0,0,2023,840,0,0,0,0,0,#DIV/0!
2863,Virginia\Dickenson,0,12,0,0,3100,2605,0,12,0,0,0,#DIV/0!
2865,Virginia\Essex,0,0,0,0,38298,38720,0,0,0,0,0,#DIV/0!
2885,Virginia\King and Queen,0,0,0,0,32324,29041,0,0,0,0,0,#DIV/0!
2888,Virginia\Lancaster,0,0,0,0,10438,7391,0,0,0,0,0,#DIV/0!
2899,Virginia\New Kent,496,0,496,0,14061,10520,0,0,0,0,0,#DIV/0!
2979,West Virginia\Boone,0,0,0,0,165,120,0,0,0,0,0,#DIV/0!
2981,West Virginia\Brooke,0,0,0,0,5142,4344,0,0,0,0,0,#DIV/0!
2984,West Virginia\Clay,7,0,7,0,4157,2202,0,0,0,0,0,#DIV/0!
2985,West Virginia\Doddridge,109,0,9,0,16369,9964,100,0,0,0,0,#DIV/0!
2991,West Virginia\Hancock,0,0,0,0,3069,3064,0,0,0,0,0,#DIV/0!
2997,West Virginia\Lewis,0,0,0,0,22107,16168,0,0,0,0,0,#DIV/0!
2999,West Virginia\Logan,0,0,0,0,326,32,0,0,0,0,0,#DIV/0!
3000,West Virginia\McDowell,0,0,0,0,500,151,0,0,0,0,0,#DIV/0!
3006,West Virginia\Mingo,0,0,0,0,311,67,0,0,0,0,0,#DIV/0!
3011,West Virginia\Ohio,4,0,4,0,10749,11859,0,0,0,0,0,#DIV/0!
3012,West Virginia\Pendleton,4,0,4,0,29598,24354,0,0,0,0,0,#DIV/0!
3013,West Virginia\Pleasants,0,0,0,0,7604,4138,0,0,0,0,0,#DIV/0!
3018,West Virginia\Randolph,27,0,0,0,25632,19843,0,0,0,0,0,#DIV/0!
3020,West Virginia\Roane,19,0,11,0,29459,21552,8,0,0,0,0,#DIV/0!
3023,West Virginia\Tucker,10,0,10,0,8649,6682,0,0,0,0,0,#DIV/0!
3028,West Virginia\Wetzel,4,0,4,0,10034,7632,0,0,0,0,0,#DIV/0!
3029,West Virginia\Wirt,0,0,0,0,9894,7701,0,0,0,0,0,#DIV/0!
3031,West Virginia\Wyoming,0,0,0,0,810,515,0,0,0,0,0,#DIV/0!
3053,Wisconsin\Forest,0,0,0,0,11049,10265,0,0,0,0,0,#DIV/0!
3072,Wisconsin\Menominee,0,0,0,0,290,422,0,0,0,0,0,#DIV/0!
3083,Wisconsin\Price,0,0,0,0,40392,39444,0,0,0,0,0,#DIV/0!
696,Indiana\Clinton,768,0,764,0,244813,211606,4,4,-4,-4,-1.89E-05,0
1897,North Carolina\Alleghany,431,0,431,0,29178,32946,0,3,-3,-3,-9.11E-05,0
998,Kentucky\Bullitt,394,0,394,0,24764,20200,0,6,-6,-6,-0.00029703,0
2328,South Carolina\Abbeville,1477,0,0,0,26447,23724,0,9,-9,-9,-0.000379363,0
2597,Texas\Delta,0,0,0,0,67353,65041,0,36,-36,-36,-0.000553497,0
2212,Oklahoma\Washington,497,0,374,0,67051,55557,123,55,-55,-55,-0.000989974,0
2693,Texas\McMullen,0,0,0,0,38464,19318,0,30,-30,-30,-0.001552956,0
393,Georgia\Carroll,662,0,599,0,25501,19371,63,38,-38,-38,-0.001961695,0
2880,Virginia\Henrico,0,0,0,0,12216,9459,9,32,-32,-32,-0.003383021,0
306,Florida\Bay,0,0,0,0,2729,2689,0,33,-33,-33,-0.01227222,0
282,Colorado\San Juan,0,0,0,0,0,0,0,0,0,0,,
1223,Massachusetts\Suffolk,7,0,7,0,12,0,0,0,0,0,,
1267,Michigan\Keweenaw,0,0,0,0,390,0,0,0,0,0,,
1757,Nevada\Mineral,0,0,0,0,6383,0,0,0,0,0,,
1760,Nevada\Storey,0,0,0,0,36,0,0,0,0,0,,
1763,Nevada\Carson City,0,0,0,0,1170,0,0,0,0,0,,
1784,New Jersey\Hudson,0,0,0,0,0,0,0,0,0,0,,
1813,New Mexico\Los Alamos,0,0,0,0,0,0,0,0,0,0,,
1834,New York\Bronx,0,0,0,0,0,0,0,0,0,0,,
1862,New York\New York,0,0,0,0,0,0,0,0,0,0,,
2589,Texas\Crane,45,0,0,0,15252,0,0,0,0,0,,
2785,Texas\Winkler,218,0,0,0,0,0,0,0,0,0,,
2844,Virginia\Arlington,0,0,0,0,32,0,0,0,0,0,,
